room	room
right on	location
staff	staff
breakfast	breakfast
location	location
restaurant	restaurant
service	staff
clean	cleanliness
bed	sleeping_comfort
place	location
friendly	staff
beach	facilities
food	restaurant
area	location
bathroom	bathroom
bar	restaurant
helpful	staff
pool	swimming_pool
comfortable	sleeping_comfort
free	value_for_money
trip	facilities
price	value_for_money
short walk	location
quiet	noise
just around	location
center	location
station	location
euro	value_for_money
drink	restaurant
desk	staff
buffet	breakfast
shower	bathroom
suite	room
reception	staff
square	location
coffee	breakfast
airport	location
dinner	restaurant
internet	internet
bus	location
check	staff
canal	location
pay	value_for_money
tv	facilities
car park	parking
expensive	value_for_money
manager	staff
shop	facilities
noise	noise
front	location
spacious	room
rate	value_for_money
money	value_for_money
window	room
walking distance	location
towel	bathroom
near	location
taxi	facilities
balcony	facilities
table	restaurant
fresh	cleanliness
help	staff
vega	restaurant
front	location
central	location
tram	location
meal	restaurant
bath	bathroom
located	location
museum	facilities
casino	facilities
wine	restaurant
tour	facilities
cheese	restaurant
close	location
shuttle	facilities
tea	breakfast
bedroom	room
fruit	breakfast
close	location
locate	location
lunch	restaurant
arrival	staff
cafe	facilities
garden	facilities
check	staff
sleep	sleeping_comfort
block	location
serve	staff
right	location
egg	breakfast
wall	room
light	room
owner	staff
concierge	staff
metro	location
cost	value_for_money
charge	value_for_money
corner	location
ocean	facilities
bread	breakfast
kitchen	facilities
parking	parking
beer	restaurant
cheap	value_for_money
noisy	noise
fridge	facilities
tub	bathroom
juice	breakfast
snack	restaurant
menu	restaurant
toilet	bathroom
attraction	facilities
pillow	sleeping_comfort
chocolate	breakfast
spot	location
dive	facilities
champagne	restaurant
spa	facilities
sea	facilities
paid	value_for_money
charge	value_for_money
shopping	facilities
cereal	breakfast
check-in	staff
polite	staff
meat	restaurant
central	location
design	room
fee	value_for_money
comfy	sleeping_comfort
decorated	room
gym	facilities
district	location
served	staff
spotless	cleanliness
checked	staff
entertainment	facilities
management	staff
fish	restaurant
clean	cleanliness
receptionist	staff
professional	staff
furniture	room
heart	location
cost	value_for_money
jacuzzi	bathroom
attentive	staff
downtown	location
rent	value_for_money
dirty	cleanliness
smell	cleanliness
free	value_for_money
sink	bathroom
cup	restaurant
walked	location
terrace	facilities
disney	facilities
pricey	value_for_money
cheaper	value_for_money
rude	staff
subway	facilities
sleep	room
overlooking	location
lift	facilities
bike	facilities
loud	noise
maid	staff
credit	value_for_money
courtyard	facilities
bill	value_for_money
dish	restaurant
sauna	facilities
situated	location
pizza	restaurant
fitness	facilities
housekeeping	cleanliness
wireless	internet
curtain	room
microwave	facilities
courteous	staff
traffic	noise
minibar	facilities
bacon	breakfast
croissant	breakfast
sheet	sleeping_comfort
boutique	facilities
swim	swimming_pool
help	staff
budget	value_for_money
carpet	room
situate	location
cleaned	cleanliness
dining	restaurant
fan	room
art	facilities
closet	room
priced	value_for_money
sofa	room
linen	sleeping_comfort
sandwich	breakfast
dine	restaurant
waiter	restaurant
cleanliness	cleanliness
swimming	swimming_pool
schiphol	facilities
mattress	sleeping_comfort
starbuck	facilities
supermarket	facilities
grocery	facilities
spotlessly	cleanliness
dollar	value_for_money
host	staff
wifi	internet
theater	facilities
soap	bathroom
price	value_for_money
garage	parking
pleasantly	staff
steak	restaurant
sound	noise
conditioning	room
shower	bathroom
calm	noise
plate	restaurant
slept	sleeping_comfort
paying	value_for_money
massage	facilities
eating	restaurant
laptop	internet
chicken	restaurant
cake	breakfast
park	parking
greeted	staff
swim	swimming_pool
markt	location
pancake	breakfast
patio	facilities
toiletries	bathroom
all-inclusive	value_for_money
transport	location
toast	breakfast
route	location
charged	value_for_money
furnished	room
guide	facilities
checkout	staff
laundry	facilities
wardrobe	room
immaculate	cleanliness
bathtub	bathroom
decoration	room
rate	value_for_money
renovated	room
milk	breakfast
tidy	cleanliness
toiletry	bathroom
clean	cleanliness
assist	staff
bargain	value_for_money
waitress	restaurant
kind	staff
bathrobe	bathroom
willing	staff
duvet	sleeping_comfort
friendliness	staff
jacuzzi	bathroom
personnel	staff
wi-fi	facilities
store	facilities
lcd	facilities
disco	facilities
roomy	room
sound	noise
bagel	breakfast
bellman	staff
diving	facilities
unfriendly	staff
conditioner	bathroom
check-out	staff
fishbone	restaurant
sushi	restaurant
drawer	room
musty	cleanliness
cheerful	staff
sail	facilities
salmon	restaurant
gracious	staff
motorway	location
shabby	cleanliness
stain	cleanliness
correct	staff
helpfull	staff
guard	staff
kind	staff
bottle	restaurant
pc	internet
scene	location
hop	location
pay	value_for_money
attendant	staff
harbor	facilities
lake	facilities
printer	internet
crew	staff
library	facilities
eager	staff
crowded	noise
cupboard	room
overprice	value_for_money
shrimp	restaurant
trapeze	facilities
needs refurbishment	room
cuisine	facilities
refund	value_for_money
whirlpool	bathroom
aircon	room
courtesy	staff
surf	facilities
cutlery	restaurant
noisy	noise
vicinity	location
wireless	internet
carpark	parking
impersonal	staff
lotion	bathroom
wallpaper	room
check-out	staff
filthy	cleanliness
iron	facilities
playa	facilities
volleyball	facilities
cycle	facilities
responsive	staff
snorkele	facilities
air-conditioning	room
helpfull	staff
hospitable	staff
smelly	cleanliness
tram	facilities
video	facilities
mushroom	restaurant
dirt	cleanliness
mildew	cleanliness
service	staff
tranquil	noise
roomy	room
indifferent	staff
claustrophobic	room
silent	noise
watersport	facilities
animal	facilities
coffe	breakfast
donut	breakfast
gambler	facilities
helpfull	staff
tucked	location
competent	staff
overprice	value_for_money
rose	restaurant
dingy	cleanliness
drinking	restaurant
professionalism	staff
tuck	location
10min	location
showerhead	bathroom
drunken	noise
restroom	facilities
stink	cleanliness
bubble	bathroom
washroom	facilities
unprofessional	staff
feather	sleeping_comfort
restraunt	restaurant
roomservice	staff
stained	cleanliness
well-located	location
bath/shower	bathroom
respectful	staff
airconditioning	room
ballroom	facilities
centraal	location
cheerfully	staff
drunk	noise
rowdy	noise
rudeness	staff
slippery	bathroom
10min	location
drank	restaurant
extortionate	value_for_money
family-run	staff
parking	parking
10min	location
hearty	staff
rudely	staff
stainless	cleanliness
airconditioning	room
plumbing	bathroom
swimmingpool	swimming_pool
tariff	value_for_money
trampoline	facilities
5min	location
bathing	bathroom
tub/shower	bathroom
carpeting	room
noisey	noise
smoke-free	facilities
understaffed	staff
air-conditioning	room
beach/pool	swimming_pool
generously	staff
hotelroom	room
one-bedroom	room
one-bedroom	room
mould	cleanliness
noisier	noise
rainshower	bathroom
showering	bathroom
soundly	sleeping_comfort
secluded	location
skype	facilities
straat	location
trainee	staff
alleyway	location
armoire	room
bars/restaurants	restaurant
sponge	bathroom
boss	staff
unclean	cleanliness
roulette	facilities
roundtrip	facilities
tonic	restaurant
townhouse	location
trainstation	location
transaction	value_for_money
inedible	restaurant
roundabout	location
attentive	staff
furnished	room
overcharged	value_for_money
room-service	staff
shower/tub	bathroom
sleepless	sleeping_comfort
stink	cleanliness
colazione	breakfast
cooperative	staff
copious	restaurant
livingroom	room
noisey	noise
freshener	cleanliness
incompetent	staff
rooom	room
rudest	staff
well-situated	location
1-bedroom	room
bedlinen	sleeping_comfort
brainpark	location
curt	staff
noise	noise
overcharge	value_for_money
showered	bathroom
sunbed	facilities
whirlpool	bathroom
aperitif	restaurant
filthy	cleanliness
jacuzzi	bathroom
kosher	restaurant
mattrass	sleeping_comfort
shower/bath	bathroom
understaffed	staff
bathroom/shower	bathroom
bunkbed	sleeping_comfort
catering	restaurant
cheese	breakfast
greasy	cleanliness
solarium	facilities
toilettry	bathroom
breakfastroom	breakfast
carpeted	room
daiquiri	restaurant
decorating	room
dietary	restaurant
dirty	cleanliness
downstair	location
expensive	value_for_money
indifference	staff
rude	staff
sterling	value_for_money
stinky	cleanliness
unwilling	staff
2-bedroom	room
bedsheet	sleeping_comfort
10euro	value_for_money
cheap	value_for_money
room	room
spaciousness	room
bathmat	bathroom
economic	value_for_money
helpfully	staff
bathrooom	bathroom
bathrrom	bathroom
cheerful	staff
price-wise	value_for_money
restauarant	restaurant
sandwhich	breakfast
sauna/steam	facilities
showergel	bathroom
toilet/shower	bathroom
two-bedroom	room
bathroon	bathroom
bathtub/shower	bathroom
noisiest	noise
noisy	noise
noisy	noise
reserved	staff
router	internet
rowdiness	noise
rumor	noise
shower/toilet	bathroom
showering	bathroom
tearoom	facilities
badroom	bathroom
bathrom	bathroom
bathtube	bathroom
bedroom	room
car-park	parking
carpeted	room
curt	staff
expensively	value_for_money
hygienic	cleanliness
integrity	staff
located	location
location-wise	location
ping-pong	facilities
pool/beach	facilities
poolbar	facilities
refurb	room
refurbishing	room
restaurent	restaurant
restaurnat	restaurant
retaurant	restaurant
roadside	location
room/bathroom	room
steambath	bathroom
sympathy	staff
windowless	room
airless	room
bath	bathroom
bathe	bathroom
blatant	noise
diningroom	restaurant
locationwise	location
playroom	facilities
reception/concierge	staff
rijkmuseum	facilities
roomkey	room
rooms/bathrooms	room
self-parking	parking
sundeck	facilities
super-clean	cleanliness
supplement	restaurant
surf	facilities
surfer	facilities
surfing	facilities
swime	swimming_pool
swiming	swimming_pool
value for money	value_for_money
budget price	value_for_money