habitación	room
a la derecha en	location
personal	staff
desayuno	breakfast
ubicación	location
restaurante	restaurant
servicio	staff
limpio	cleanliness
cama	sleeping_comfort
lugar	location
amistoso	staff
playa	facilities
comida	restaurant
zona	location
cuarto de baño	bathroom
bar	restaurant
útil	staff
piscina	swimming_pool
cómodo	sleeping_comfort
libre	value_for_money
viaje	facilities
precio	value_for_money
corto paseo	location
tranquilo	noise
a la vuelta de	location
centro	location
estación	location
euro	value_for_money
bebida	restaurant
escritorio	staff
bufé	breakfast
ducha	bathroom
suite	room
recepción	staff
plaza	location
café	breakfast
aeropuerto	location
cena	restaurant
Internet	internet
autobús	location
comprobar	staff
canal	location
pagar	value_for_money
TV	facilities
aparcamiento	parking
caro	value_for_money
gerente	staff
tienda	facilities
ruido	noise
frente	location
espacioso	room
velocidad	value_for_money
dinero	value_for_money
ventana	room
distancia caminando	location
toalla	bathroom
cerca	location
taxi	facilities
balcón	facilities
tabla	restaurant
fresco	cleanliness
ayudar	staff
vega	restaurant
frente	location
central	location
tranvía	location
comida	restaurant
baño	bathroom
situado	location
museo	facilities
casino	facilities
vino	restaurant
gira	facilities
queso	restaurant
cerca	location
lanzadera	facilities
té	breakfast
dormitorio	room
fruta	breakfast
cerca	location
localizar	location
almuerzo	restaurant
llegada	staff
café	facilities
jardín	facilities
comprobar	staff
sueño	sleeping_comfort
bloque	location
servir	staff
derecho	location
huevo	breakfast
pared	room
luz	room
propietario	staff
conserje	staff
metro	location
costo	value_for_money
cobrar	value_for_money
esquina	location
océano	facilities
pan	breakfast
cocina	facilities
aparcamiento	parking
cerveza	restaurant
barato	value_for_money
ruidoso	noise
nevera	facilities
bañera	bathroom
jugo	breakfast
bocadillo	restaurant
menú	restaurant
inodoro	bathroom
atracción	facilities
almohada	sleeping_comfort
chocolate	breakfast
lugar	location
inmersión	facilities
champán	restaurant
spa	facilities
mar	facilities
pagado	value_for_money
cobrar	value_for_money
compras	facilities
cereal	breakfast
facturación	staff
cortés	staff
carne	restaurant
central	location
diseño	room
cuota	value_for_money
confortable	sleeping_comfort
decorado	room
gimnasio	facilities
distrito	location
servido	staff
inmaculado	cleanliness
comprobado	staff
entretenimiento	facilities
administración	staff
pescado	restaurant
limpio	cleanliness
recepcionista	staff
profesional	staff
muebles	room
corazón	location
costo	value_for_money
jacuzzi	bathroom
atento	staff
centro de la ciudad	location
renta	value_for_money
sucio	cleanliness
olor	cleanliness
libre	value_for_money
fregadero	bathroom
taza	restaurant
caminado	location
terraza	facilities
disney	facilities
caro	value_for_money
más barato	value_for_money
grosero	staff
metro	facilities
sueño	room
con vista a	location
ascensor	facilities
bicicleta	facilities
fuerte	noise
mucama	staff
crédito	value_for_money
patio	facilities
proyecto de ley	value_for_money
plato	restaurant
sauna	facilities
situado	location
pizza	restaurant
aptitud	facilities
limpieza	cleanliness
sin hilos	internet
cortina	room
microonda	facilities
cortés	staff
tráfico	noise
minibar	facilities
tocino	breakfast
croissant	breakfast
hoja	sleeping_comfort
Boutique	facilities
nadar	swimming_pool
ayudar	staff
presupuesto	value_for_money
alfombra	room
situar	location
limpiar	cleanliness
comida	restaurant
ventilador	room
arte	facilities
armario	room
caro	value_for_money
sofá	room
lino	sleeping_comfort
sandwich	breakfast
cenar	restaurant
camarero	restaurant
limpieza	cleanliness
natación	swimming_pool
Schiphol	facilities
colchón	sleeping_comfort
Starbuck	facilities
supermercado	facilities
tienda de comestibles	facilities
impecablemente	cleanliness
dólar	value_for_money
anfitrión	staff
wifi	internet
teatro	facilities
jabón	bathroom
precio	value_for_money
garaje	parking
agradablemente	staff
filete	restaurant
sonido	noise
acondicionamiento	room
ducha	bathroom
calmar	noise
placa	restaurant
dormido	sleeping_comfort
pago	value_for_money
masaje	facilities
comida	restaurant
laptop	internet
pollo	restaurant
pastel	breakfast
parque	parking
recibidos	staff
nadar	swimming_pool
markt	location
crepe	breakfast
patio	facilities
artículos de tocador	bathroom
todo incluido	value_for_money
transporte	location
brindis	breakfast
ruta	location
cargado	value_for_money
amueblado	room
guiar	facilities
caja	staff
lavandería	facilities
armario	room
inmaculado	cleanliness
bañera	bathroom
decoración	room
velocidad	value_for_money
renovado	room
leche	breakfast
ordenado	cleanliness
artículos de aseo	bathroom
limpio	cleanliness
ayudar	staff
ganga	value_for_money
camarera	restaurant
tipo	staff
albornoz	bathroom
complaciente	staff
edredón	sleeping_comfort
amabilidad	staff
jacuzzi	bathroom
personal	staff
wi-fi	facilities
tienda	facilities
lcd	facilities
discoteca	facilities
espacioso	room
sonido	noise
rosquilla	breakfast
botones	staff
buceo	facilities
hostil	staff
acondicionador	bathroom
de salida	staff
espina de pescado	restaurant
sushi	restaurant
cajón	room
rancio	cleanliness
alegre	staff
vela	facilities
salmón	restaurant
gracioso	staff
autopista	location
lamentable	cleanliness
mancha	cleanliness
correcto	staff
servicial	staff
guardia	staff
tipo	staff
botella	restaurant
pc	internet
escena	location
hop	location
pagar	value_for_money
asistente	staff
puerto	facilities
lago	facilities
impresora	internet
tripulación	staff
biblioteca	facilities
ansioso	staff
lleno de gente	noise
armario	room
sobreprecio	value_for_money
camarón	restaurant
trapecio	facilities
necesita reformas	room
cocina	facilities
reembolso	value_for_money
torbellino	bathroom
aire acondicionado	room
cortesía	staff
oleaje	facilities
cubiertos	restaurant
ruidoso	noise
vecindad	location
sin hilos	internet
aparcamiento	parking
impersonal	staff
loción	bathroom
papel pintado	room
de salida	staff
inmundo	cleanliness
hierro	facilities
playa	facilities
voleibol	facilities
ciclo	facilities
sensible	staff
snorkele	facilities
aire acondicionado	room
servicial	staff
hospitalario	staff
maloliente	cleanliness
tranvía	facilities
vídeo	facilities
seta	restaurant
suciedad	cleanliness
moho	cleanliness
servicio	staff
tranquilo	noise
espacioso	room
indiferente	staff
claustrofóbico	room
silencioso	noise
deportes acuáticos	facilities
animal	facilities
coffe	breakfast
buñuelo	breakfast
jugador	facilities
servicial	staff
escondido	location
competente	staff
sobreprecio	value_for_money
rosa	restaurant
sucio	cleanliness
bebida	restaurant
profesionalismo	staff
pliegue	location
10min	location
Ducha	bathroom
borracho	noise
aseos	facilities
hedor	cleanliness
burbuja	bathroom
baño	facilities
no profesional	staff
pluma	sleeping_comfort
restraunt	restaurant
roomservice	staff
manchado	cleanliness
bien situado	location
baño / ducha	bathroom
respetuoso	staff
aire acondicionado	room
salón de baile	facilities
centraal	location
alegremente	staff
borracho	noise
ruidoso	noise
grosería	staff
resbaladizo	bathroom
10min	location
bebió	restaurant
exorbitante	value_for_money
de gestión familiar,	staff
aparcamiento	parking
10min	location
abundante	staff
groseramente	staff
inoxidable	cleanliness
aire acondicionado	room
plomería	bathroom
piscina	swimming_pool
arancel	value_for_money
trampolín	facilities
5min	location
baños	bathroom
bañera / ducha	bathroom
alfombras	room
ruidoso	noise
libre de humo	facilities
falto de personal	staff
aire acondicionado	room
playa / piscina	swimming_pool
generosamente	staff
hotelroom	room
de un dormitorio	room
de un dormitorio	room
molde	cleanliness
más ruidoso	noise
rainshower	bathroom
ducharse	bathroom
sólidamente	sleeping_comfort
aislado	location
skype	facilities
straat	location
aprendiz	staff
callejón	location
armario	room
bares / restaurantes	restaurant
esponja	bathroom
jefe	staff
inmundo	cleanliness
ruleta	facilities
ida y vuelta	facilities
tónico	restaurant
casa de pueblo	location
estación	location
transacción	value_for_money
incomible	restaurant
rotonda	location
atento	staff
amueblado	room
sobrecargada	value_for_money
servicio de habitaciones	staff
ducha / bañera	bathroom
insomne	sleeping_comfort
hedor	cleanliness
colazione	breakfast
cooperativa	staff
copioso	restaurant
salón	room
ruidoso	noise
ambientador	cleanliness
incompetente	staff
rooom	room
más rudo	staff
bien situado	location
1 dormitorio	room
ropa de cama	sleeping_comfort
Brainpark	location
brusco	staff
ruido	noise
cargo excesivo	value_for_money
duchado	bathroom
cama solar	facilities
torbellino	bathroom
aperitivo	restaurant
inmundo	cleanliness
jacuzzi	bathroom
kosher	restaurant
totalmenete	sleeping_comfort
ducha / baño	bathroom
falto de personal	staff
baño / ducha	bathroom
litera	sleeping_comfort
abastecimiento	restaurant
queso	breakfast
grasiento	cleanliness
solárium	facilities
toilettry	bathroom
breakfastroom	breakfast
alfombrada	room
daiquiri	restaurant
decoración	room
dietético	restaurant
sucio	cleanliness
búngalos	location
caro	value_for_money
indiferencia	staff
grosero	staff
libra esterlina	value_for_money
apestoso	cleanliness
reacio	staff
2 dormitorios	room
bedsheet	sleeping_comfort
€ 10	value_for_money
barato	value_for_money
habitación	room
amplitud	room
bathmat	bathroom
económico	value_for_money
servicialmente	staff
bathrooom	bathroom
bathrrom	bathroom
alegre	staff
en cuanto al precio	value_for_money
restauarant	restaurant
sándwich	breakfast
sauna / vapor	facilities
showergel	bathroom
baño / ducha	bathroom
de dos dormitorios	room
de baño	bathroom
bañera / ducha	bathroom
más ruidosa	noise
ruidoso	noise
ruidoso	noise
reservado	staff
enrutador	internet
alboroto	noise
rumor	noise
ducha / WC	bathroom
ducharse	bathroom
salón de té	facilities
baño fantástico	bathroom
bathrom de	bathroom
bañera	bathroom
dormitorio	room
aparcamiento	parking
alfombrada	room
brusco	staff
costosamente	value_for_money
higiénico	cleanliness
integridad	staff
situado	location
cuanto a la ubicación	location
ping-pong	facilities
piscina / playa	facilities
poolbar	facilities
reforma	room
Reformas	room
Restaurent	restaurant
restaurnat	restaurant
retaurant	restaurant
borde del camino	location
habitación / baño	room
baño de vapor	bathroom
simpatía	staff
sin ventanas	room
sin aire	room
baño	bathroom
bañarse	bathroom
descarado	noise
comedor	restaurant
a ubicación	location
cuarto de jugar	facilities
recepción / conserje	staff
Rijkmuseum	facilities
roomkey	room
habitaciones / baños	room
aparcamiento de autoservicio	parking
solarium	facilities
super limpio	cleanliness
suplemento	restaurant
oleaje	facilities
tablista	facilities
surf	facilities
swime	swimming_pool
natación	swimming_pool
relación calidad-precio	value_for_money
precio asequible	value_for_money
