habitación	noun	room
a la derecha en	multi_word_expression	location
personal	noun	staff
desayuno	noun	breakfast
ubicación	noun	location
restaurante	noun	restaurant
servicio	noun	staff
limpio	adj	cleanliness
cama	noun	sleeping_comfort
lugar	noun	location
amistoso	adj	staff
playa	noun	facilities
comida	noun	restaurant
zona	noun	location
cuarto de baño	noun	bathroom
bar	noun	restaurant
útil	adj	staff
piscina	noun	swimming_pool
cómodo	adj	sleeping_comfort
libre	adj	value_for_money
viaje	noun	facilities
precio	noun	value_for_money
corto paseo	multi_word_expression	location
tranquilo	adj	noise
a la vuelta de	multi_word_expression	location
centro	noun	location
estación	noun	location
euro	noun	value_for_money
bebida	noun	restaurant
escritorio	noun	staff
bufé	noun	breakfast
ducha	verb	bathroom
suite	noun	room
recepción	noun	staff
plaza	noun	location
café	noun	breakfast
aeropuerto	noun	location
cena	noun	restaurant
Internet	noun	internet
autobús	noun	location
comprobar	verb	staff
canal	noun	location
pagar	verb	value_for_money
TV	noun	facilities
aparcamiento	multi_word_expression	parking
caro	adj	value_for_money
gerente	noun	staff
tienda	noun	facilities
ruido	noun	noise
frente	adj	location
espacioso	adj	room
velocidad	noun	value_for_money
dinero	noun	value_for_money
ventana	noun	room
distancia caminando	multi_word_expression	location
toalla	noun	bathroom
cerca	prep	location
taxi	noun	facilities
balcón	noun	facilities
tabla	noun	restaurant
fresco	adj	cleanliness
ayudar	verb	staff
vega	noun	restaurant
frente	noun	location
central	adj	location
tranvía	noun	location
comida	noun	restaurant
baño	noun	bathroom
situado	verb	location
museo	noun	facilities
casino	noun	facilities
vino	noun	restaurant
gira	noun	facilities
queso	noun	restaurant
cerca	adv	location
lanzadera	noun	facilities
té	noun	breakfast
dormitorio	noun	room
fruta	noun	breakfast
cerca	adj	location
localizar	verb	location
almuerzo	noun	restaurant
llegada	noun	staff
café	noun	facilities
jardín	noun	facilities
comprobar	noun	staff
sueño	verb	sleeping_comfort
bloque	noun	location
servir	verb	staff
derecho	noun	location
huevo	noun	breakfast
pared	noun	room
luz	noun	room
propietario	noun	staff
conserje	noun	staff
metro	noun	location
costo	noun	value_for_money
cobrar	noun	value_for_money
esquina	noun	location
océano	noun	facilities
pan	noun	breakfast
cocina	noun	facilities
aparcamiento	noun	parking
cerveza	noun	restaurant
barato	adj	value_for_money
ruidoso	adj	noise
nevera	noun	facilities
bañera	noun	bathroom
jugo	noun	breakfast
bocadillo	noun	restaurant
menú	noun	restaurant
inodoro	noun	bathroom
atracción	noun	facilities
almohada	noun	sleeping_comfort
chocolate	noun	breakfast
lugar	noun	location
inmersión	noun	facilities
champán	noun	restaurant
spa	noun	facilities
mar	noun	facilities
pagado	verb	value_for_money
cobrar	verb	value_for_money
compras	noun	facilities
cereal	noun	breakfast
facturación	noun	staff
cortés	adj	staff
carne	noun	restaurant
central	noun	location
diseño	noun	room
cuota	noun	value_for_money
confortable	adj	sleeping_comfort
decorado	verb	room
gimnasio	noun	facilities
distrito	noun	location
servido	verb	staff
inmaculado	adj	cleanliness
comprobado	verb	staff
entretenimiento	noun	facilities
administración	noun	staff
pescado	noun	restaurant
limpio	verb	cleanliness
recepcionista	noun	staff
profesional	adj	staff
muebles	noun	room
corazón	noun	location
costo	verb	value_for_money
jacuzzi	noun	bathroom
atento	adj	staff
centro de la ciudad	noun	location
renta	verb	value_for_money
sucio	adj	cleanliness
olor	noun	cleanliness
libre	noun	value_for_money
fregadero	noun	bathroom
taza	noun	restaurant
caminado	verb	location
terraza	noun	facilities
disney	noun	facilities
caro	adj	value_for_money
más barato	adj	value_for_money
grosero	adj	staff
metro	noun	facilities
sueño	noun	room
con vista a	verb	location
ascensor	noun	facilities
bicicleta	noun	facilities
fuerte	adj	noise
mucama	noun	staff
crédito	noun	value_for_money
patio	noun	facilities
proyecto de ley	noun	value_for_money
plato	noun	restaurant
sauna	noun	facilities
situado	verb	location
pizza	noun	restaurant
aptitud	noun	facilities
limpieza	noun	cleanliness
sin hilos	adj	internet
cortina	noun	room
microonda	noun	facilities
cortés	adj	staff
tráfico	noun	noise
minibar	noun	facilities
tocino	noun	breakfast
croissant	noun	breakfast
hoja	noun	sleeping_comfort
Boutique	noun	facilities
nadar	verb	swimming_pool
ayudar	noun	staff
presupuesto	noun	value_for_money
alfombra	noun	room
situar	verb	location
limpiar	verb	cleanliness
comida	noun	restaurant
ventilador	noun	room
arte	noun	facilities
armario	noun	room
caro	verb	value_for_money
sofá	noun	room
lino	noun	sleeping_comfort
sandwich	noun	breakfast
cenar	noun	restaurant
camarero	noun	restaurant
limpieza	noun	cleanliness
natación	noun	swimming_pool
Schiphol	noun	facilities
colchón	noun	sleeping_comfort
Starbuck	noun	facilities
supermercado	noun	facilities
tienda de comestibles	noun	facilities
impecablemente	adv	cleanliness
dólar	noun	value_for_money
anfitrión	noun	staff
wifi	noun	internet
teatro	noun	facilities
jabón	noun	bathroom
precio	verb	value_for_money
garaje	noun	parking
agradablemente	adv	staff
filete	noun	restaurant
sonido	noun	noise
acondicionamiento	noun	room
ducha	noun	bathroom
calmar	adj	noise
placa	noun	restaurant
dormido	verb	sleeping_comfort
pago	verb	value_for_money
masaje	noun	facilities
comida	verb	restaurant
laptop	noun	internet
pollo	noun	restaurant
pastel	noun	breakfast
parque	verb	parking
recibidos	verb	staff
nadar	noun	swimming_pool
markt	noun	location
crepe	noun	breakfast
patio	noun	facilities
artículos de tocador	noun	bathroom
todo incluido	adj	value_for_money
transporte	noun	location
brindis	noun	breakfast
ruta	noun	location
cargado	verb	value_for_money
amueblado	verb	room
guiar	noun	facilities
caja	noun	staff
lavandería	noun	facilities
armario	noun	room
inmaculado	adj	cleanliness
bañera	noun	bathroom
decoración	noun	room
velocidad	verb	value_for_money
renovado	verb	room
leche	noun	breakfast
ordenado	adj	cleanliness
artículos de aseo	noun	bathroom
limpio	noun	cleanliness
ayudar	verb	staff
ganga	noun	value_for_money
camarera	noun	restaurant
tipo	adj	staff
albornoz	noun	bathroom
complaciente	adj	staff
edredón	noun	sleeping_comfort
amabilidad	noun	staff
jacuzzi	adj	bathroom
personal	noun	staff
wi-fi	adj	facilities
tienda	verb	facilities
lcd	noun	facilities
discoteca	noun	facilities
espacioso	noun	room
sonido	adj	noise
rosquilla	noun	breakfast
botones	noun	staff
buceo	noun	facilities
hostil	adj	staff
acondicionador	noun	bathroom
de salida	noun	staff
espina de pescado	noun	restaurant
sushi	noun	restaurant
cajón	noun	room
rancio	adj	cleanliness
alegre	adj	staff
vela	noun	facilities
salmón	noun	restaurant
gracioso	adj	staff
autopista	noun	location
lamentable	adj	cleanliness
mancha	noun	cleanliness
correcto	adj	staff
servicial	noun	staff
guardia	noun	staff
tipo	adv	staff
botella	adj	restaurant
pc	noun	internet
escena	noun	location
hop	noun	location
pagar	noun	value_for_money
asistente	noun	staff
puerto	noun	facilities
lago	noun	facilities
impresora	noun	internet
tripulación	noun	staff
biblioteca	noun	facilities
ansioso	adj	staff
lleno de gente	adj	noise
armario	noun	room
sobreprecio	verb	value_for_money
camarón	noun	restaurant
trapecio	noun	facilities
necesita reformas	multi_word_expression	room
cocina	noun	facilities
reembolso	noun	value_for_money
torbellino	noun	bathroom
aire acondicionado	noun	room
cortesía	noun	staff
oleaje	noun	facilities
cubiertos	noun	restaurant
ruidoso	noun	noise
vecindad	noun	location
sin hilos	noun	internet
aparcamiento	noun	parking
impersonal	adj	staff
loción	noun	bathroom
papel pintado	noun	room
de salida	adj	staff
inmundo	adj	cleanliness
hierro	verb	facilities
playa	noun	facilities
voleibol	noun	facilities
ciclo	noun	facilities
sensible	adj	staff
snorkele	noun	facilities
aire acondicionado	noun	room
servicial	adv	staff
hospitalario	adj	staff
maloliente	adj	cleanliness
tranvía	verb	facilities
vídeo	noun	facilities
seta	noun	restaurant
suciedad	noun	cleanliness
moho	noun	cleanliness
servicio	verb	staff
tranquilo	noun	noise
espacioso	adj	room
indiferente	adj	staff
claustrofóbico	adj	room
silencioso	adj	noise
deportes acuáticos	noun	facilities
animal	noun	facilities
coffe	noun	breakfast
buñuelo	noun	breakfast
jugador	noun	facilities
servicial	adj	staff
escondido	verb	location
competente	adj	staff
sobreprecio	adj	value_for_money
rosa	noun	restaurant
sucio	adj	cleanliness
bebida	verb	restaurant
profesionalismo	noun	staff
pliegue	verb	location
10min	noun	location
Ducha	noun	bathroom
borracho	adj	noise
aseos	noun	facilities
hedor	verb	cleanliness
burbuja	noun	bathroom
baño	noun	facilities
no profesional	adj	staff
pluma	noun	sleeping_comfort
restraunt	noun	restaurant
roomservice	noun	staff
manchado	adj	cleanliness
bien situado	adj	location
baño / ducha	noun	bathroom
respetuoso	adj	staff
aire acondicionado	noun	room
salón de baile	noun	facilities
centraal	adj	location
alegremente	adv	staff
borracho	adj	noise
ruidoso	adj	noise
grosería	noun	staff
resbaladizo	adj	bathroom
10min	adj	location
bebió	verb	restaurant
exorbitante	adj	value_for_money
de gestión familiar,	adj	staff
aparcamiento	verb	parking
10min	other	location
abundante	noun	staff
groseramente	adv	staff
inoxidable	adj	cleanliness
aire acondicionado	verb	room
plomería	noun	bathroom
piscina	noun	swimming_pool
arancel	noun	value_for_money
trampolín	noun	facilities
5min	noun	location
baños	noun	bathroom
bañera / ducha	noun	bathroom
alfombras	noun	room
ruidoso	adj	noise
libre de humo	adj	facilities
falto de personal	verb	staff
aire acondicionado	adj	room
playa / piscina	noun	swimming_pool
generosamente	adv	staff
hotelroom	noun	room
de un dormitorio	noun	room
de un dormitorio	adj	room
molde	noun	cleanliness
más ruidoso	adj	noise
rainshower	noun	bathroom
ducharse	verb	bathroom
sólidamente	adv	sleeping_comfort
aislado	adj	location
skype	noun	facilities
straat	noun	location
aprendiz	noun	staff
callejón	noun	location
armario	noun	room
bares / restaurantes	noun	restaurant
esponja	noun	bathroom
jefe	noun	staff
inmundo	adj	cleanliness
ruleta	noun	facilities
ida y vuelta	noun	facilities
tónico	adj	restaurant
casa de pueblo	noun	location
estación	noun	location
transacción	noun	value_for_money
incomible	adj	restaurant
rotonda	noun	location
atento	noun	staff
amueblado	adj	room
sobrecargada	verb	value_for_money
servicio de habitaciones	noun	staff
ducha / bañera	noun	bathroom
insomne	adj	sleeping_comfort
hedor	noun	cleanliness
colazione	noun	breakfast
cooperativa	adj	staff
copioso	adj	restaurant
salón	noun	room
ruidoso	noun	noise
ambientador	noun	cleanliness
incompetente	adj	staff
rooom	noun	room
más rudo	adj	staff
bien situado	adj	location
1 dormitorio	adj	room
ropa de cama	noun	sleeping_comfort
Brainpark	noun	location
brusco	noun	staff
ruido	verb	noise
cargo excesivo	verb	value_for_money
duchado	verb	bathroom
cama solar	verb	facilities
torbellino	adj	bathroom
aperitivo	noun	restaurant
inmundo	noun	cleanliness
jacuzzi	verb	bathroom
kosher	noun	restaurant
totalmenete	noun	sleeping_comfort
ducha / baño	noun	bathroom
falto de personal	adj	staff
baño / ducha	noun	bathroom
litera	noun	sleeping_comfort
abastecimiento	verb	restaurant
queso	verb	breakfast
grasiento	noun	cleanliness
solárium	noun	facilities
toilettry	noun	bathroom
breakfastroom	noun	breakfast
alfombrada	verb	room
daiquiri	noun	restaurant
decoración	noun	room
dietético	adj	restaurant
sucio	noun	cleanliness
búngalos	verb	location
caro	noun	value_for_money
indiferencia	noun	staff
grosero	noun	staff
libra esterlina	noun	value_for_money
apestoso	adj	cleanliness
reacio	adj	staff
2 dormitorios	adj	room
bedsheet	noun	sleeping_comfort
€ 10	noun	value_for_money
barato	noun	value_for_money
habitación	other	room
amplitud	noun	room
bathmat	noun	bathroom
económico	adj	value_for_money
servicialmente	adv	staff
bathrooom	noun	bathroom
bathrrom	noun	bathroom
alegre	noun	staff
en cuanto al precio	noun	value_for_money
restauarant	noun	restaurant
sándwich	noun	breakfast
sauna / vapor	adj	facilities
showergel	noun	bathroom
baño / ducha	noun	bathroom
de dos dormitorios	adj	room
de baño	noun	bathroom
bañera / ducha	noun	bathroom
más ruidosa	adj	noise
ruidoso	verb	noise
ruidoso	adv	noise
reservado	adj	staff
enrutador	noun	internet
alboroto	noun	noise
rumor	noun	noise
ducha / WC	noun	bathroom
ducharse	noun	bathroom
salón de té	noun	facilities
baño fantástico	noun	bathroom
bathrom de	noun	bathroom
bañera	noun	bathroom
dormitorio	adj	room
aparcamiento	noun	parking
alfombrada	adj	room
brusco	adj	staff
costosamente	adv	value_for_money
higiénico	adj	cleanliness
integridad	noun	staff
situado	adj	location
cuanto a la ubicación	noun	location
ping-pong	adj	facilities
piscina / playa	adj	facilities
poolbar	noun	facilities
reforma	verb	room
Reformas	noun	room
Restaurent	adj	restaurant
restaurnat	noun	restaurant
retaurant	adj	restaurant
borde del camino	noun	location
habitación / baño	noun	room
baño de vapor	noun	bathroom
simpatía	noun	staff
sin ventanas	adj	room
sin aire	adj	room
baño	verb	bathroom
bañarse	verb	bathroom
descarado	adj	noise
comedor	noun	restaurant
a ubicación	noun	location
cuarto de jugar	noun	facilities
recepción / conserje	noun	staff
Rijkmuseum	noun	facilities
roomkey	noun	room
habitaciones / baños	noun	room
aparcamiento de autoservicio	noun	parking
solarium	noun	facilities
super limpio	adj	cleanliness
suplemento	verb	restaurant
oleaje	verb	facilities
tablista	noun	facilities
surf	verb	facilities
swime	verb	swimming_pool
natación	verb	swimming_pool
relación calidad-precio	multi_word_expression	value_for_money
precio asequible	multi_word_expression	value_for_money
