chambre	noun	room
à droite sur	multi_word_expression	location
personnel	noun	staff
petit déjeuner	noun	breakfast
emplacement	noun	location
restaurant	noun	restaurant
service	noun	staff
propre	adj	cleanliness
lit	noun	sleeping_comfort
lieu	noun	location
amical	adj	staff
plage	noun	facilities
nourriture	noun	restaurant
région	noun	location
salle de bain	noun	bathroom
bar	noun	restaurant
utile	adj	staff
piscine	noun	swimming_pool
confortable	adj	sleeping_comfort
gratuit	adj	value_for_money
voyage	noun	facilities
prix	noun	value_for_money
courte distance de marche	multi_word_expression	location
calme	adj	noise
juste	multi_word_expression	location
centre	noun	location
station	noun	location
euro	noun	value_for_money
boisson	noun	restaurant
bureau	noun	staff
buffet	noun	breakfast
douche	verb	bathroom
suite	noun	room
réception	noun	staff
carré	noun	location
café	noun	breakfast
aéroport	noun	location
dîner	noun	restaurant
Internet	noun	internet
bus	noun	location
vérifier	verb	staff
canal	noun	location
payer	verb	value_for_money
TV	noun	facilities
parking	multi_word_expression	parking
cher	adj	value_for_money
directeur	noun	staff
boutique	noun	facilities
bruit	noun	noise
avant	adj	location
spacieux	adj	room
taux	noun	value_for_money
argent	noun	value_for_money
fenêtre	noun	room
distance de marche	multi_word_expression	location
serviette	noun	bathroom
près de	prep	location
taxi	noun	facilities
balcon	noun	facilities
table	noun	restaurant
frais	adj	cleanliness
aider	verb	staff
vega	noun	restaurant
avant	noun	location
central	adj	location
tram	noun	location
repas	noun	restaurant
bain	noun	bathroom
situé	verb	location
musée	noun	facilities
casino	noun	facilities
vin	noun	restaurant
tour	noun	facilities
fromage	noun	restaurant
proche	adv	location
navette	noun	facilities
thé	noun	breakfast
chambre à coucher	noun	room
fruit	noun	breakfast
proche	adj	location
localiser	verb	location
déjeuner	noun	restaurant
arrivée	noun	staff
café	noun	facilities
jardin	noun	facilities
vérifier	noun	staff
sommeil	verb	sleeping_comfort
bloc	noun	location
servir	verb	staff
droit	noun	location
œuf	noun	breakfast
mur	noun	room
lumière	noun	room
propriétaire	noun	staff
concierge	noun	staff
métro	noun	location
coût	noun	value_for_money
charger	noun	value_for_money
coin	noun	location
océan	noun	facilities
pain	noun	breakfast
cuisine	noun	facilities
parking	noun	parking
bière	noun	restaurant
pas cher	adj	value_for_money
bruyant	adj	noise
frigo	noun	facilities
cuve	noun	bathroom
jus	noun	breakfast
casse-croûte	noun	restaurant
menu	noun	restaurant
toilette	noun	bathroom
attraction	noun	facilities
oreiller	noun	sleeping_comfort
chocolat	noun	breakfast
place	noun	location
plongeon	noun	facilities
champagne	noun	restaurant
spa	noun	facilities
mer	noun	facilities
payé	verb	value_for_money
charger	verb	value_for_money
shopping	noun	facilities
céréale	noun	breakfast
enregistrement	noun	staff
poli	adj	staff
viande	noun	restaurant
central	noun	location
conception	noun	room
frais	noun	value_for_money
confortable	adj	sleeping_comfort
décoré	verb	room
gym	noun	facilities
district	noun	location
servi	verb	staff
impeccable	adj	cleanliness
à carreaux	verb	staff
divertissement	noun	facilities
gestion	noun	staff
poisson	noun	restaurant
propre	verb	cleanliness
réceptionniste	noun	staff
professionnel	adj	staff
meubles	noun	room
cœur	noun	location
coût	verb	value_for_money
jacuzzi	noun	bathroom
attentif	adj	staff
centre-ville	noun	location
louer	verb	value_for_money
sale	adj	cleanliness
odeur	noun	cleanliness
gratuit	noun	value_for_money
évier	noun	bathroom
tasse	noun	restaurant
marché	verb	location
terrasse	noun	facilities
disney	noun	facilities
cher	adj	value_for_money
moins cher	adj	value_for_money
grossier	adj	staff
métro	noun	facilities
sommeil	noun	room
négligence	verb	location
soulever	noun	facilities
vélo	noun	facilities
fort	adj	noise
femme de chambre	noun	staff
crédit	noun	value_for_money
cour	noun	facilities
projet de loi	noun	value_for_money
plat	noun	restaurant
sauna	noun	facilities
situé	verb	location
pizza	noun	restaurant
forme	noun	facilities
ménagère	noun	cleanliness
sans fil	adj	internet
rideau	noun	room
micro-onde	noun	facilities
courtois	adj	staff
trafic	noun	noise
minibar	noun	facilities
bacon	noun	breakfast
croissant	noun	breakfast
feuille	noun	sleeping_comfort
boutique	noun	facilities
natation	verb	swimming_pool
aider	noun	staff
budget	noun	value_for_money
tapis	noun	room
situer	verb	location
nettoyé	verb	cleanliness
à manger	noun	restaurant
fan	noun	room
art	noun	facilities
toilettes	noun	room
cher	verb	value_for_money
sofa	noun	room
lin	noun	sleeping_comfort
sandwich	noun	breakfast
dîner	noun	restaurant
serveur	noun	restaurant
propreté	noun	cleanliness
piscine	noun	swimming_pool
Schiphol	noun	facilities
matelas	noun	sleeping_comfort
Starbuck	noun	facilities
supermarché	noun	facilities
épicerie	noun	facilities
impeccablement	adv	cleanliness
dollar	noun	value_for_money
hôte	noun	staff
wifi	noun	internet
théâtre	noun	facilities
savon	noun	bathroom
prix	verb	value_for_money
garage	noun	parking
agréablement	adv	staff
steak	noun	restaurant
son	noun	noise
conditionnement	noun	room
douche	noun	bathroom
calmer	adj	noise
plaque	noun	restaurant
dormi	verb	sleeping_comfort
payant	verb	value_for_money
massage	noun	facilities
nourriture	verb	restaurant
portatif	noun	internet
poulet	noun	restaurant
gâteau	noun	breakfast
parc	verb	parking
accueillis	verb	staff
natation	noun	swimming_pool
markt	noun	location
crêpe	noun	breakfast
patio	noun	facilities
articles de toilette	noun	bathroom
tout compris	adj	value_for_money
transport	noun	location
toast	noun	breakfast
route	noun	location
chargé	verb	value_for_money
meublé	verb	room
guider	noun	facilities
caisse	noun	staff
blanchisserie	noun	facilities
garde-robe	noun	room
immaculé	adj	cleanliness
baignoire	noun	bathroom
décoration	noun	room
taux	verb	value_for_money
rénové	verb	room
lait	noun	breakfast
propre	adj	cleanliness
cosmétique	noun	bathroom
propre	noun	cleanliness
aider	verb	staff
négocier	noun	value_for_money
serveuse	noun	restaurant
genre	adj	staff
peignoir de bain	noun	bathroom
prêt	adj	staff
duvet	noun	sleeping_comfort
convivialité	noun	staff
jacuzzi	adj	bathroom
personnel	noun	staff
wi-fi	adj	facilities
magasin	verb	facilities
lcd	noun	facilities
disco	noun	facilities
spacieux	noun	room
son	adj	noise
bagel	noun	breakfast
groom	noun	staff
plongée	noun	facilities
hostile	adj	staff
conditionneur	noun	bathroom
départ	noun	staff
arête de poisson	noun	restaurant
sushi	noun	restaurant
tiroir	noun	room
de moisi	adj	cleanliness
gai	adj	staff
voile	noun	facilities
saumon	noun	restaurant
gracieux	adj	staff
autoroute	noun	location
minable	adj	cleanliness
tache	noun	cleanliness
correct	adj	staff
serviable	noun	staff
garde	noun	staff
genre	adv	staff
bouteille	adj	restaurant
ordinateur personnel	noun	internet
scène	noun	location
houblon	noun	location
payer	noun	value_for_money
préposé	noun	staff
port	noun	facilities
lac	noun	facilities
imprimeur	noun	internet
équipage	noun	staff
bibliothèque	noun	facilities
désireux	adj	staff
bondé	adj	noise
placard	noun	room
vendre trop cher	verb	value_for_money
crevette	noun	restaurant
trapèze	noun	facilities
besoins de rénovation	multi_word_expression	room
cuisine	noun	facilities
remboursement	noun	value_for_money
tourbillon	noun	bathroom
climatisation	noun	room
courtoisie	noun	staff
Surf	noun	facilities
couverts	noun	restaurant
bruyant	noun	noise
environs	noun	location
sans fil	noun	internet
parking	noun	parking
impersonnel	adj	staff
lotion	noun	bathroom
papier peint	noun	room
départ	adj	staff
crasseux	adj	cleanliness
fer	verb	facilities
playa	noun	facilities
volley-ball	noun	facilities
cycle	noun	facilities
sensible	adj	staff
snorkele	noun	facilities
climatisation	noun	room
serviable	adv	staff
hospitalier	adj	staff
malodorant	adj	cleanliness
tram	verb	facilities
vidéo	noun	facilities
champignon	noun	restaurant
saleté	noun	cleanliness
mildiou	noun	cleanliness
service	verb	staff
tranquille	noun	noise
spacieux	adj	room
indifférent	adj	staff
claustrophobe	adj	room
silencieux	adj	noise
sports nautiques	noun	facilities
animal	noun	facilities
café	noun	breakfast
beignet	noun	breakfast
parieur	noun	facilities
serviable	adj	staff
niché	verb	location
compétent	adj	staff
vendre trop cher	adj	value_for_money
rose	noun	restaurant
sombre	adj	cleanliness
potable	verb	restaurant
professionnalisme	noun	staff
rempli	verb	location
10min	noun	location
douche	noun	bathroom
ivre	adj	noise
toilettes	noun	facilities
puanteur	verb	cleanliness
bulle	noun	bathroom
toilettes	noun	facilities
peu professionnel	adj	staff
plume	noun	sleeping_comfort
restraunt	noun	restaurant
roomservice	noun	staff
coloré	adj	cleanliness
bien situé	adj	location
bain / douche	noun	bathroom
respectueux	adj	staff
climatisation	noun	room
salle de bal	noun	facilities
centraal	adj	location
gaiement	adv	staff
ivre	adj	noise
chahuteur	adj	noise
grossièreté	noun	staff
glissant	adj	bathroom
10min	adj	location
bu	verb	restaurant
exorbitant	adj	value_for_money
familial	adj	staff
parking	verb	parking
10min	other	location
copieux	noun	staff
grossièrement	adv	staff
inoxydable	adj	cleanliness
climatisation	verb	room
plomberie	noun	bathroom
piscine	noun	swimming_pool
tarif	noun	value_for_money
trampoline	noun	facilities
5min	noun	location
baignade	noun	bathroom
baignoire / douche	noun	bathroom
moquette	noun	room
bruyant	adj	noise
sans fumée	adj	facilities
en sous-	verb	staff
climatisation	adj	room
plage / piscine	noun	swimming_pool
généreusement	adv	staff
chambre d'hôtel	noun	room
une chambre	noun	room
une chambre	adj	room
moule	noun	cleanliness
bruyants	adj	noise
douche à effet pluie	noun	bathroom
douche	verb	bathroom
judicieusement	adv	sleeping_comfort
isolé	adj	location
skype	noun	facilities
straat	noun	location
stagiaire	noun	staff
ruelle	noun	location
armoire	noun	room
bars / restaurants	noun	restaurant
éponge	noun	bathroom
patron	noun	staff
impur	adj	cleanliness
roulette	noun	facilities
aller-retour	noun	facilities
tonique	adj	restaurant
maison de ville	noun	location
gare	noun	location
transaction	noun	value_for_money
immangeable	adj	restaurant
manège	noun	location
attentif	noun	staff
meublé	adj	room
surfacturé	verb	value_for_money
room-service	noun	staff
douche / baignoire	noun	bathroom
sans sommeil	adj	sleeping_comfort
puanteur	noun	cleanliness
colazione	noun	breakfast
coopérative	adj	staff
copieux	adj	restaurant
living	noun	room
bruyant	noun	noise
assainisseur	noun	cleanliness
incompétent	adj	staff
rooom	noun	room
plus grossier	adj	staff
bien situé	adj	location
1 chambre à coucher	adj	room
draps	noun	sleeping_comfort
Brainpark	noun	location
sec	noun	staff
bruit	verb	noise
surcharge	verb	value_for_money
douchés	verb	bathroom
lit de plage	verb	facilities
tourbillon	adj	bathroom
apéritif	noun	restaurant
crasseux	noun	cleanliness
jacuzzi	verb	bathroom
kascher	noun	restaurant
mattrass	noun	sleeping_comfort
douche / bain	noun	bathroom
en sous-	adj	staff
salle de bain / douche	noun	bathroom
lits superposés	noun	sleeping_comfort
restauration	verb	restaurant
fromage	verb	breakfast
graisseux	noun	cleanliness
solarium	noun	facilities
toilettry	noun	bathroom
salle des petits déjeuners	noun	breakfast
moquette	verb	room
daiquiri	noun	restaurant
décoration	noun	room
diététique	adj	restaurant
sale	noun	cleanliness
downstair	verb	location
cher	noun	value_for_money
indifférence	noun	staff
grossier	noun	staff
sterling	noun	value_for_money
puante	adj	cleanliness
réticent	adj	staff
2 chambres à coucher	adj	room
drap	noun	sleeping_comfort
€ 10	noun	value_for_money
pas cher	noun	value_for_money
chambre	other	room
espace	noun	room
tapis de bain	noun	bathroom
économique	adj	value_for_money
utilement	adv	staff
bathrooom	noun	bathroom
bathrrom	noun	bathroom
gai	noun	staff
prix sages	noun	value_for_money
Restauarant	noun	restaurant
sandwich	noun	breakfast
sauna / hammam	adj	facilities
showergel	noun	bathroom
WC / douche	noun	bathroom
deux chambres à coucher	adj	room
bathroon	noun	bathroom
baignoire / douche	noun	bathroom
bruyants	adj	noise
bruyant	verb	noise
bruyant	adv	noise
réservé	adj	staff
routeur	noun	internet
chahut	noun	noise
rumeur	noun	noise
douche / WC	noun	bathroom
douche	noun	bathroom
salon de thé	noun	facilities
badroom	noun	bathroom
bathrom	noun	bathroom
baignoire	noun	bathroom
chambre à coucher	adj	room
stationnement	noun	parking
moquette	adj	room
sec	adj	staff
cher	adv	value_for_money
hygiénique	adj	cleanliness
intégrité	noun	staff
situé	adj	location
lieu-sage	noun	location
ping-pong	adj	facilities
piscine / plage	adj	facilities
pool-bar	noun	facilities
refurb	verb	room
remise à neuf	noun	room
restaurent	adj	restaurant
restaurnat	noun	restaurant
retaurant	adj	restaurant
bord de la route	noun	location
chambre / salle de bains	noun	room
hammam	noun	bathroom
sympathie	noun	staff
fenêtre	adj	room
privé d'air	adj	room
bain	verb	bathroom
baignade	verb	bathroom
flagrant	adj	noise
salle à manger	noun	restaurant
Question emplacement	noun	location
salle de jeux	noun	facilities
réception / conciergerie	noun	staff
Rijksmuseum	noun	facilities
roomkey	noun	room
chambres / salle de bains	noun	room
auto-parking	noun	parking
terrasse	noun	facilities
super propre	adj	cleanliness
supplément	verb	restaurant
Surf	verb	facilities
surfeur	noun	facilities
surf	verb	facilities
swime	verb	swimming_pool
natation	verb	swimming_pool
valeur pour l'argent	multi_word_expression	value_for_money
prix budget	multi_word_expression	value_for_money