abbastanza	adv	 
accanto	adv	lig
accappatoi	nom	san
accessibile	adj	lig
accessibile	adj	lig
accessibili	adj	lig
accesso	nom	lig
accessoriata	ver	fac
accessoriate	adj	fac
accoglienza	adj	pers
accoglienza	nom	pers
accolto	ver	pers
acqua	nom	san
addetti	nom	pers
addetto	nom	pers
addetto	adj	pers
adiacente	nom	lig
adiacente	adj	lig
adiacenti	adj	lig
aereoporto	nom	lig
aeroporto	nom	lig
affabile	adj	pers
affaccia	ver	lig
affacciano	ver	lig
affacciata	ver	lig
affacciava	ver	lig
affaccio	nom	lig
affare	nom	prijs
affari	nom	prijs
aiutare	ver	pers
aiutato	ver	pers
alexanderplatz	nom	lig
alimenti	nom	rest
all'aereoporto	nom	lig
all'aeroporto	ver	lig
all'aeroporto	adj	lig
all'aeroporto	nom	lig
all'altezza	ver	lig
all'altezza	adj	lig
all'altezza	nom	lig
all'aperto	adj	fac
all'arrivo	adj	pers
all'arrivo	ver	pers
all'arrivo	nom	pers
all'autostrada	adj	lig
all'autostrada	nom	lig
all'esterno	ver	fac
altissima	other	prijs
amburgo	nom	lig
amichevole	adj	pers
amstel	nom	lig
amstel	adj	lig
amsterdam	ver	lig
amsterdam	nom	lig
amsterdam	loa	lig
amsterdam	adj	lig
animazione	nom	fac
aperitivo	nom	rest
appartamenti	nom	kam/fac
appartamento	nom	kam/fac
area	nom	lig
aree	nom	lig
armadi	nom	kam
armadio	nom	kam
arredamenti	adj	kam
arredamenti	nom	kam
arredamento	adj	kam
arredamento	nom	kam
arredata	adj	kam
arredata	ver	kam
arredate	adj	kam
arredate	ver	kam
arredato	ver	kam
arredi	nom	kam
arredi	adj	kam
arredo	nom	kam
arredo	adj	kam
arrivando	ver	pers
arrivarci	ver	lig
arrivare	ver	lig
arrivata	ver	lig
arrivate	ver	lig
arrivati	ver	lig
arrivato	ver	lig
arrivo	nom	pers
ascensore	adj	fac
ascensore	nom	fac
ascensori	nom	fac
asciugacapelli	adj	san
asciugamani	adj	san
asciugamani	nom	san
asciugamani	ver	san
assistenza	nom	pers
astronomica	other	prijs
astronomico	other	prijs
atene	nom	lig
attrezzata	ver	fac
attrezzate	adj	fac
attrezzato	ver	fac
attrezzature	nom	fac
auto	nom	park
autobus	nom	lig
bagagli	nom	fac
bagaglio	nom	fac
bagni	adj	san
bagni	nom	san
bagno	nom	san
bagnoschiuma	adj	san
bahn	adj	lig
bahn	loa	lig
balcone	nom	kam
bar	nom	rest
barcellona	nom	lig
battelli	nom	lig
battello	nom	lig
baviera	nom	lig
benvenuto	nom	pers
berlino	ver	lig
berlino	nom	lig
bevanda	nom	rest
bevande	nom	rest
biancheria	nom	bed/san
biancheria	adj	bed/san
bici	nom	lig
bici	adj	lig
bicicletta	nom	lig
biciclette	adj	lig
biciclette	nom	lig
bidet	loa	san
bidet	nom	san
birra	nom	rest
bollitore	nom	fac/kam
bollitore	adj	fac/kam
bologna	nom	lig
bosco	nom	lig
box	nom	park
brandeburgo	nom	lig
brasserie	nom	rest
breakfast	loa	ontb
breakfast	nom	ontb
briciole	nom	rest
bruges	nom	lig
budapest	nom	lig
buffet	loa	rest
buffet	nom	rest
bus	nom	lig
bus	loa	lig
bustine	nom	rest
cabina	nom	fac
caffe	nom	rest
caffe'	nom	rest
caffé	nom	rest
caffè	adj	rest
caffè	nom	rest
caffè	loa	rest
calda	other	kam
caldamente	adv	pers
calde	adj	kam/rest/ontb
calde	other	kam
caldi	adj	rest
caldo	other	kam
calma	nom	law
calme	adj	law
cambi	nom	kam
cambiare	ver	kam
cambiata	ver	kam
cambiati	ver	kam
cambiato	ver	kam
cambio	nom	kam
cambio	ver	kam
camera	nom	kam
camere	nom	kam
cameriera	nom	pers
cameriere	nom	pers
camerieri	nom	pers
camino	nom	fac
camminare	ver	lig
camminata	nom	lig
cammino	nom	lig
campagna	nom	lig
campi	nom	lig
campo	nom	lig
canal	nom	lig
canale	nom	lig
canali	nom	lig
cannes	nom	lig
cantiere	nom	lig
caos	nom	law
capelli	nom	hyg
capitale	nom	lig
capolinea	nom	lig
cappuccino	ver	ontb
cappuccino	nom	ontb
carne	nom	rest
caro	other	prijs
caro	other	prijs
casinò	adj	fac
casinò	nom	fac
cassaforte	nom	fac/kam
castello	nom	lig
cattedrale	nom	lig
cauzione	nom	prijs
cena	nom	rest
cenare	ver	rest
cenato	ver	rest
center	adj	lig
centraal	nom	lig
central	adj	lig
central	nom	lig
centrale	adj	lig
centrale	nom	lig
centrali	adj	lig
centralissima	adj	lig
centralissimo	adj	lig
centralità	nom	lig
centre	adj	lig
centri	nom	lig
centro	nom	lig
champagne	nom	rest
champs	loa	lig
charlie	loa	lig
check	adj	pers
check	loa	pers
check	nom	pers
checkout	nom	pers
chiesa	nom	lig
chilometri	nom	lig
cialde	nom	ontb
cibi	nom	rest
cibo	nom	rest
cifra	nom	prijs
cifre	nom	prijs
cioccolata	ver	rest
cioccolata	nom	rest
circondato	ver	lig
circostante	adj	lig
citta	adj	lig
citta	nom	lig
citta'	nom	lig
citta'	adj	lig
città	nom	lig
città	adj	lig
città	ver	lig
cittadina	nom	lig
cittadino	adj	lig
city	adj	lig
city	nom	lig
climatizzazione	nom	kam
cocktail	nom	rest
coffe	nom	rest
coffee	nom	rest
coffee	adj	rest
colazione	nom	ontb
colazioni	nom	ontb
collegamenti	nom	lig
collegamento	nom	lig
collegano	ver	lig
collegata	ver	lig
collegato	ver	lig
collocato	ver	lig
collocazione	nom	lig
colonia	nom	lig
comfort	ver	kam
comfort	nom	kam
comfort	loa	kam
commerciale	adj	lig
commerciali	adj	lig
comoda	adj	kam/lig
comoda	ver	kam/lig
comoda	nom	kam/lig
comodamente	adv	kam/lig
comode	ver	kam/lig
comode	adj	kam/lig
comodi	ver	kam/lig
comodi	adj	kam/lig
comodino	nom	kam
comodita'	nom	kam/lig
comodita'	adj	kam/lig
comodità	nom	kam/lig
comodità	adj	kam/lig
comodo	nom	kam/lig
compenso	nom	prijs
competente	adj	pers
competenza	nom	pers
complessivo	adj	prijs
computer	nom	fac
concierge	nom	pers
condizionata	ver	kam/fac
confort	loa	kam
confort	ver	kam
confort	nom	kam
confortable	adj	kam
confortable	nom	kam
confortevole	ver	kam
confortevole	nom	kam
confortevole	adj	kam
confortevoli	adj	kam
confortevoli	ver	kam
confusione	nom	law
connessione	nom	fac
connessione	loa	fac
contanti	nom	prijs
continentale	adj	ontb
conto	nom	prijs
conveniente	ver	prijs
conveniente	adj	prijs
convenienti	adj	prijs
coperta	adj	kam
coperto	ver	rest
cordiale	adj	pers
cordiali	adj	pers
cordialissimo	adj	pers
cordialita'	nom	pers
cordialità	nom	pers
cordialità	adj	pers
cornetti	nom	ontb
cortese	ver	pers
cortese	adj	pers
cortese	nom	pers
cortesi	adj	pers
cortesia	nom	pers
cortile	nom	fac
costa	ver	prijs
costa	nom	lig
costano	ver	prijs
costava	ver	prijs
costi	nom	prijs
costo	nom	prijs
costosa	adj	prijs
costosi	ver	prijs
costoso	adj	prijs
cottura	adj	rest
cucina	nom	rest
culturale	adj	lig
culturali	adj	lig
cuore	nom	lig
cuscini	nom	kam
cuscini	adj	kam
cuscino	ver	kam
cuscino	nom	kam
custodito	adj	park
d'acqua	adj	lig
dall'aereoporto	adj	lig
dall'aeroporto	nom	lig
dall'aeroporto	adj	lig
dall'albergo	adj	lig
dall'albergo	nom	lig
dall'autostrada	adj	lig
dall'hotel	adj	lig
dall'hotel	ver	lig
dall'hotel	nom	lig
dall'ingresso	adj	lig
dall'isola	adj	lig
dam	adj	lig
dam	ver	lig
dam	nom	lig
damrak	nom	lig
danubio	nom	lig
d'arte	adj	lig
datato	ver	kam
decentrata	ver	lig
decentrata	adj	lig
decentrato	ver	lig
dell'auto	adj	park
dell'autobus	loa	lig
dell'autostrada	adj	lig
dell'isola	adj	lig
deposito	nom	fac/prijs
design	nom	kam
design	adj	kam
desk	nom	pers
difronte	adj	lig
dimensione	nom	kam
dimensioni	nom	kam
d'interesse	adj	lig
dintorni	adj	lig
dintorni	nom	lig
dipendenti	nom	pers
direttore	nom	pers
direzione	nom	pers
discoteche	nom	fac
disponibilissimo	adj	pers
dista	ver	lig
dista	nom	lig
dista	adj	lig
distante	adj	lig
distanti	adj	lig
distanza	nom	lig
distanza	other	lig
district	loa	lig
divano	nom	kam
divano	ver	kam
docce	nom	san
doccia	ver	san
doccia	adj	san
doccia	nom	san
dolcetti	nom	rest
dolci	adj	rest
doppia	adj	kam
dorme	ver	kam
dormire	ver	kam
dormito	ver	kam
dotata	ver	kam
dotate	adj	kam
dotate	nom	kam
dotate	ver	kam
dotati	ver	kam
dotato	ver	kam
dotazione	nom	kam
dotazioni	nom	kam
dresda	nom	lig
duomo	nom	lig
duomo	adj	lig
eccessivo	other	prijs
economica	adj	prijs
economici	adj	prijs
economico	adj	prijs
edifici	nom	lig
edificio	nom	lig
efficente	adj	pers
efficenza	nom	pers
efficiente	adj	pers
efficienti	adj	pers
efficienza	nom	pers
eiffel	adj	lig
eindhoven	nom	lig
enorme	adj	kam
enormi	adj	kam
escursioni	nom	fac
esorbitante	other	prijs
euro	ver	prijs
euro	adj	prijs
euro	nom	prijs
familiare	adj	kam
fermata	ver	lig
fermata	nom	lig
fermata	adj	lig
fermata	loa	lig
fermate	ver	lig
ferrovia	nom	lig
ferroviaria	adj	lig
fianco	nom	lig
fiera	adj	lig
fiera	nom	lig
fieristico	adj	lig
fila	nom	lig
finestra	nom	kam
finestre	nom	kam
finestre	ver	kam
finestre	adj	kam
finiture	nom	kam
fiori	nom	kam
fitness	loa	fac
fitness	nom	fac
fiume	nom	lig
formaggi	adj	rest
francese	adj	pers
francoforte	nom	lig
friburgo	nom	lig
frigo	adj	kam
frigo	nom	kam
frigobar	adj	kam
frigobar	nom	kam
frigorifero	nom	kam
fronte	nom	lig
frutta	nom	rest
garage	adj	park
garage	nom	park
garbato	ver	pers
gentile	nom	pers
gentile	ver	pers
gentile	adj	pers
gentilezza	adj	pers
gentilezza	nom	pers
gentilezza	ver	pers
gentili	adj	pers
gentilissimi	adj	pers
gentilissimo	adj	pers
gentillesse	nom	pers
geografica	adj	lig
germania	nom	lig
gestione	nom	pers
gestito	ver	pers
ghiaccio	nom	rest
giardino	nom	fac
giardino	ver	fac
giochi	nom	fac
giornaliera	adj	kam
giornaliere	adj	kam
giornalieri	adj	kam
giornaliero	adj	kam
giornalmente	adv	kam
giovanile	adj	pers
gita	ver	lig
gite	nom	lig
gradi	nom	kam
gran	adj	kam
grand	adj	kam
grande	adj	kam
grandezza	nom	kam
grandi	adj	kam
grandissima	nom	kam
grandissime	adj	kam
grandissimo	adj	kam
gratis	adv	prijs
gratuita	loa	prijs
gratuita	ver	prijs
gratuitamente	adv	prijs
gratuite	adj	prijs
gratuiti	adj	prijs
gratuiti	ver	prijs
gratuito	adj	prijs
gratuito	loa	prijs
gratuito	nom	prijs
gratuito	ver	prijs
guardaroba	nom	kam/fac
gustare	ver	rest
gusti	nom	rest
gustosa	adj	rest
idromassaggio	adj	fac
idromassaggio	nom	fac
igienica	adj	san
igienici	adj	san
imbanditi	adj	rest
inclusa	adj	prijs
inclusa	ver	prijs
inclusi	adj	prijs
inclusive	adj	prijs
incluso	adj	prijs
infrastrutture	nom	lig
insonorizzata	ver	law
insonorizzate	adj	law
insonorizzate	ver	law
insonorizzazione	nom	law
internet	ver	fac
internet	loa	fac
internet	nom	fac
irrisoria	other	prijs
isola	nom	lig
isolata	ver	lig
jacuzzi	nom	san
katharo	adj	lig
king	nom	kam
king	adj	kam
l'accoglienza	adj	pers
l'accoglienza	nom	pers
l'acqua	adj	san
l'acqua	nom	san
l'aereoporto	nom	lig
l'aeroporto	adj	lig
l'aeroporto	nom	lig
laghetto	nom	lig
lago	nom	lig
l'animazione	nom	fac
l'appartamento	nom	kam
l'arredamento	adj	kam
l'arredamento	nom	kam
l'arredamento	ver	kam
l'arredo	adj	kam
l'arredo	nom	kam
l'ascensore	nom	fac
l'ascensore	adj	fac
latte	nom	ontb
l'attenzione	nom	pers
l'auto	adj	park
l'auto	nom	park
l'autobus	nom	lig
lavabo	nom	san
lavabo	adj	san
lavandino	ver	san
lavandino	nom	san
lavarsi	ver	san
lcd	adj	kam
l'efficienza	adj	pers
l'efficienza	nom	pers
leidseplein	nom	lig
lenzuola	nom	kam
letti	nom	kam
letti	adj	kam
lettini	nom	kam
lettino	nom	kam
letto	nom	kam
letto	ver	kam
l'insonorizzazione	nom	law
l'isola	nom	lig
località	nom	lig
l'olanda	nom	lig
londra	nom	lig
lontana	adj	lig
lontananza	nom	lig
lontanissimo	adj	lig
lontano	adj	lig
l'ubicazione	nom	lig
luminosa	adj	kam
luminosa	ver	kam
luminose	adj	kam
luminoso	adj	kam
lungomare	ver	lig
luoghi	nom	lig
luogo	nom	lig
macchina	nom	park
mail	nom	fac
malta	nom	lig
manager	nom	pers
mangia	nom	rest
mangia	ver	rest
mangiare	ver	rest
mangiato	ver	rest
mare	nom	lig
margini	nom	lig
marienplatz	nom	lig
massaggi	adj	fac
massaggi	nom	fac
materassi	adj	bed
materassi	nom	bed
materasso	nom	bed
matrimoniale	adj	bed
matrimoniale	nom	kam
matrimoniali	adj	kam
menu	nom	rest
menù	nom	rest
mercatini	nom	lig
mercato	nom	lig
mete	ver	lig
metro	nom	lig
metro'	nom	lig
metrò	adj	lig
metrò	nom	lig
metropolitana	adj	lig
mette	ver	lig
microonde	nom	kam/fac/rest/ontb
microonde	adj	kam/fac/rest/ontb
milano	nom	lig
minibar	adj	kam
minibar	nom	kam
mitte	nom	lig
mitte	adj	lig
mobili	adj	kam
mobilio	nom	kam
moderna	adj	kam
moderne	adj	kam
moderni	adj	kam
modernissimo	adj	kam
modernità	nom	kam
moderno	adj	kam
modici	adj	prijs
monaco	nom	lig
monemvasia	nom	lig
monumenti	nom	lig
moquette	adj	kam
moquette	nom	kam
morbidi	adj	kam/rest/ontb
morbido	adj	kam/rest/ontb
moto	nom	park
movida	nom	law
mozzafiato	ver	lig
mulini	nom	lig
multilingue	adj	pers
muri	nom	kam
muro	nom	kam
musei	nom	lig
museo	nom	lig
museum	adj	lig
natura	nom	lig
naturale	adj	lig
navetta	nom	fac/lig
navigazione	nom	lig
negozi	nom	lig
negozi	ver	lig
negozio	nom	lig
nespresso	adj	kam/ontb/rest
nizza	nom	lig
noleggiare	ver	fac
noleggio	adj	fac
noleggio	nom	fac
notte	nom	kam/law
notti	nom	kam/law
notturna	adj	kam/law
notturni	adj	kam/law
notturno	adj	kam/law
odore	nom	hyg
olanda	nom	lig
omaggio	nom	prijs
operatori	nom	pers
ordinata	adj	kam
ordinate	adj	kam
ordinato	ver	kam
ordine	nom	kam
ospitale	adj	pers
ospitalità	adj	pers
ospitalità	nom	pers
paceville	nom	lig
padova	nom	lig
paesaggio	nom	lig
paese	nom	lig
paesi	nom	lig
pagamento	nom	prijs
pagando	ver	prijs
pagare	ver	prijs
pagata	ver	prijs
pagato	ver	prijs
palazzo	nom	lig
palestra	adj	fac
palestra	nom	fac
pane	nom	rest
panetteria	nom	lig
panificio	nom	lig
panorama	nom	lig
panoramica	adj	lig
paraggi	nom	lig
parcheggi	nom	park
parcheggiare	adj	park
parcheggiare	ver	park
parcheggio	adj	park
parcheggio	nom	park
parco	nom	lig
parete	ver	kam
pareti	nom	kam
parigi	nom	lig
park	adj	lig
park	nom	lig
parking	nom	park
passeggiata	nom	lig
passeggiate	nom	lig
pasti	nom	rest
pasticcini	adj	rest
pasto	nom	rest
pavimento	nom	kam/rest/san
pazienza	other	pers
pazienza	other	pers
pc	adj	fac
pc	nom	fac
pedonale	adj	lig
pelle	nom	kam
percorso	nom	lig
periferia	nom	lig
periferica	adj	lig
pernottamento	nom	kam
pernottato	ver	kam
personale	nom	pers
pesce	nom	rest
phon	adj	san
phon	nom	san
piatti	nom	rest
piatto	nom	rest
piatto	adj	rest
piazza	nom	lig
piazze	nom	lig
piazzetta	nom	lig
piedi	nom	lig
pietanze	nom	rest
piscina	nom	fac
piscina	ver	fac
piscina	adj	fac
piscine	nom	fac
piscine	adj	fac
pizza	nom	rest
plasma	nom	kam
platz	ver	lig
platz	adj	lig
polvere	ver	hyg
porto	nom	lig
posizionato	ver	lig
posizione	nom	lig
posizone	nom	lig
postazione	nom	fac
postazioni	nom	fac
posteggio	nom	park
posteggio	adj	park
posti	nom	park
posto	nom	park
potsdamer	nom	lig
praga	nom	lig
pranzo	nom	rest
premuroso	adj	pers
presentazione	nom	kam/rest/ontb
pressi	nom	lig
prezzi	nom	prijs
prezzo	adj	prijs
prezzo	nom	prijs
privilegiata	ver	lig
prodotti	nom	rest
professionale	adj	pers
professionali	adj	pers
professionalita'	nom	pers
professionalità	adj	pers
professionalità	nom	pers
prontamente	adv	pers
prontezza	nom	pers
prossimità	nom	lig
pub	nom	lig
pub	adj	lig
puliscono	ver	hyg
pulita	nom	hyg
pulita	aux	hyg
pulita	ver	hyg
pulite	aux	hyg
pulite	ver	hyg
pulite	nom	hyg
puliti	adj	hyg
puliti	nom	hyg
pulitissima	adj	hyg
pulitissime	adj	hyg
pulitissimi	adj	hyg
pulitissimo	adj	hyg
pulito	ver	hyg
pulito	aux	hyg
pulito	nom	hyg
pulito	adj	hyg
pulizia	nom	hyg
pulizie	nom	hyg
pulizie	adj	hyg
quadrupla	adj	kam
qualificato	ver	pers
quartiere	nom	lig
quartieri	nom	lig
raggiunge	ver	lig
raggiungere	ver	lig
raggiungerlo	ver	lig
raggiungibile	adj	lig
raggiungibili	adj	lig
raggiunto	ver	lig
ragionevole	adj	prijs
rai	nom	kam
rai	adj	kam
rambla	nom	lig
reception	nom	pers
reception	adj	pers
receptionist	nom	pers
regalato	ver	prijs
regolabile	adj	kam
rembrandt	nom	lig
rembrandt	loa	lig 
rembrandtplein	nom	lig
rembrant	loa	lig
residenziale	adj	lig
ricezione	nom	pers
rifinite	ver	kam
rifiniture	nom	kam
rijksmuseum	nom	lig
rinnovato	adj	kam/rest/san/fac
riposare	ver	kam/law/lig
riposo	nom	kam/law/lig
riscaldamento	nom	kam 
riscaldata	ver	kam
riservatezza	nom	pers
riservato	adj	pers
riservato	ver	pers
rispetto	nom	pers
ristorante	nom	rest
ristoranti	nom	rest
ristorantini	nom	lig 
ristorazione	nom	rest
ristrutturare	ver	kam
ristrutturato	ver	kam
ristrutturazione	nom	kam
roma	nom	lig
room	adj	kam/rest/fac/pers
room	loa	kam/rest/fac/pers
rumore	nom	law
rumori	nom	law
rumori	adj	law
rumorosa	adj	law
rumorose	adj	law
rumoroso	nom	law
rumoroso	adj	law
salata	ver	rest
salato	nom	rest
salato	ver	rest
sanitari	nom	san
sapone	nom	san
saponette	adj	san
satellitare	adj	kam
sauna	adj	fac
sauna	nom	fac
sauna	ver	fac
saune	adj	fac
saune	nom	fac
schermo	nom	kam
schipol	nom	lig
sconto	nom	prijs
scortese	adj	pers
scrivania	adj	kam
scrivania	nom	kam
sdraio	nom	fac/kam
sedia	nom	kam/rest
sedie	nom	kam/rest
service	adj	pers
servizi	nom	san
servizievole	adj	pers
servizio	nom	pers
shampoo	adj	san
shampoo	nom	san
shop	adj	lig
shopping	adj	lig
shopping	nom	lig
shuttle	adj	fac/lig
silenzio	nom	law
silenziosa	adj	law
silenziose	ver	law
silenziose	adj	law
silenziosissima	adj	law
silenziosissimo	adj	law
silenziosità	adj	law
silenziosità	nom	law
silenzioso	adj	law
simpatia	nom	pers
simpatica	adj	pers
simpatico	adj	pers
singel	adj	lig
singola	adj	kam 
singoli	adj	kam 
sistemazione	nom	kam
siti	nom	lig
sito	nom	lig
situata	ver	lig
situato	ver	lig
situazione	nom	lig
size	adj	kam
snack	nom	rest
snack	adj	rest
soffitto	nom	kam/rest/xx
solarium	adj	fac
soldi	nom	prijs
sollecitudine	nom	pers
sonno	nom	kam/law
sorridente	adj	pers
sorriso	nom	pers
sovrapprezzo	nom	prijs
spartano	ver	kam
spaziosa	ver	kam
spaziosa	adj	kam
spaziose	ver	kam
spaziose	adj	kam
spaziosi	adj	kam
spaziosissima	adj	kam
spaziosità	nom	kam
spazioso	adj	kam
spazioso	nom	kam
spazioso	ver	kam
spende	ver	prijs
spendendo	ver	prijs
spendere	ver	prijs
spesa	nom	prijs
spese	nom	prijs
speso	ver	prijs
spettacoli	nom	fac/lig
spettacolo	nom	fac/lig
spiagge	nom	fac/lig
spiaggia	nom	fac/lig
spittelmarkt	loa	lig
sporca	adj	hyg
sporche	adj	hyg
sporchi	adj	hyg
sporco	adj	hyg
sporco	ver	hyg
sporco	nom	hyg
spostamenti	nom	lig
spostamento	nom	lig
spostarsi	ver	lig
square	adj	lig
staff	nom	pers
stampante	nom	fac
stampante	adj	fac
stampare	ver	fac
stanza	nom	kam
stanze	adj	kam
stanze	nom	kam
stanze	ver	kam
station	adj	lig
stazione	nom	lig
stazione	adj	lig
stazione	loa	lig
stazioni	nom	lig
sterline	nom	prijs
stiro	nom	fac/kam
storici	adj	lig
storico	adj	lig
strada	nom	lig
strade	nom	lig
strategica	adj	lig
strategico	adj	lig
strutture	nom	lig
succhi	nom	ontb
suggestiva	adj	lig
suite	nom	kam
suite	ver	kam
superficie	nom	kam
superior	adj	kam
superior	nom	kam
supermercati	nom	lig
supermercato	nom	lig
supplemento	nom	prijs
tangenziale	nom	lig
tanti	other	prijs
tanto	other	prijs
tariffa	adj	prijs
tariffa	ver	prijs
tariffa	nom	prijs
tariffe	nom	prijs
tassa	nom	prijs
tavoli	nom	rest
tavolino	nom	rest
tavolo	nom	rest
tax	adj	prijs
tè	nom	rest
tè	adj	rest
teatro	nom	lig
telecomando	ver	kam/fac
telefono	nom	kam/fac
televisione	nom	kam/fac
televisore	nom	kam/fac
televisore	adj	kam/fac
temperatura	adj	kam/fac/san/rest/ontb
temperatura	nom	kam/fac/san/rest/ontb
temperature	nom	kam/fac/san/rest/ontb
tenda	nom	kam
tende	ver	kam
terme	nom	fac
terminal	nom	lig 
termini	nom	lig
terrazza	nom	kam/fac
terrazza	adj	kam/fac
terrazzo	nom	kam/fac
terreno	adj	lig
tetti	nom	kam
tetto	nom	kam
the	loa	kam/ontb/rest
thè	adj	kam/ontb/rest
thè	nom	kam/ontb/rest
torre	nom	lig
torta	nom	rest
tour	nom	fac
trafficata	ver	law
traffico	nom	law
tragitto	nom	lig 
tram	nom	lig
tram	loa	lig
tram	adj	lig
trasporti	nom	lig
trasporto	nom	lig
treni	nom	lig
treno	nom	lig
trionfo	nom	lig
tripla	nom	kam
tripla	adj	kam
turistica	adj	lig
turistiche	adj	lig
turistici	adj	lig
turistico	adj	lig
tv	nom	kam
ubicato	ver	lig
ubicazione	nom	lig
uffici	nom	lig
un'offerta	nom	prijs
uova	nom	rest
usufruire	ver	fac
usufruito	ver	fac
utrecht	nom	lig
utrecht	loa	lig
valige	nom	kam/pers/fac
valigia	nom	kam/pers/fac
valigie	nom	kam/pers/fac
valletta	nom	lig
vasca	nom	san
vasca	adj	san
veduta	nom	lig
venceslao	adj	lig
veneto	adj	lig
venezia	nom	lig
ventilatore	nom	kam/fac
verona	nom	lig
viale	nom	lig
vicinanza	nom	lig
vicinanze	nom	lig
vicinissima	adj	lig
vicinissimi	adj	lig
vicinissimo	adj	lig
victoria	adj	lig
victoria	nom	lig
vienna	nom	lig
vino	nom	rest
vista	nom	lig
volendam	nom	lig
vondelpark	adj	lig
vondelpark	nom	lig
wc	nom	san
wellness	loa	fac
westminster	nom	lig
wifi	adj	kam/fac
wifi	nom	kam/fac
wireless	loa	kam/fac
wireless	nom	kam/fac
yogurt	loa	ontb
york	adj	lig
zona	nom	lig
zone	nom	lig
zoologico	adj	lig
zuid	adj	lig
