brandschoon	adj	cleanliness
dweilen	verb	cleanliness
fris	adj	cleanliness
goor	adj	cleanliness
groezelig	adj	cleanliness
haar	noun	cleanliness
hygienisch	adj	cleanliness
muis	noun	cleanliness
net	adj	cleanliness
netheid	noun	cleanliness
peuk	noun	cleanliness
proper	adj	cleanliness
rioollucht	noun	cleanliness
rook	noun	cleanliness
rooklucht	noun	cleanliness
schimmel	other	cleanliness
schimmelplek	noun	cleanliness
schone	other	cleanliness
schoon	adj	cleanliness
schoonhouden	verb	cleanliness
schoonmaak	noun	cleanliness
schoonmaakster	noun	cleanliness
schoonmaken	verb	cleanliness
schoonmaker	noun	cleanliness
smerig	adj	cleanliness
spin	noun	cleanliness
spinnenweb	noun	cleanliness
stank	noun	cleanliness
stinken	verb	cleanliness
stof	noun	cleanliness
stoffig	adj	cleanliness
stofzuigen	verb	cleanliness
stofzuiger	noun	cleanliness
superschoon	noun	cleanliness
vies	adj	cleanliness
viezig	adj	cleanliness
viezigheid	noun	cleanliness
vlek	noun	cleanliness
vuil	adj	cleanliness
onfris	adj	cleanliness
computer	noun	internet
draadloos	adj	internet
internet	other	internet
internet	noun	internet
internetaansluiting	noun	internet
internetten	verb	internet
internetverbinding	noun	internet
pc	noun	internet
wifi	noun	internet
2-persoonskamer	noun	room
afleven	verb	room
airco	noun	room
airconditioning	noun	room
balcon	noun	room
balkondeur	noun	room
bank	noun	room
bedlampje	noun	room
behang	noun	room
design	other	room
eenpersoonskamer	noun	room
fauteuil	noun	room
gehoorig	adj	room
gordijn	noun	room
hok	noun	room
hotelkamer	noun	room
inrichten	verb	room
interieur	noun	room
kamer.	noun	room
kamer	other	room
kamer	noun	room
kamer	verb	room
kamerdeur	noun	room
kamertje	noun	room
kast	noun	room
kastje	noun	room
kastruimte	noun	room
kastruimte	verb	room
kledingkast	noun	room
klimaat	noun	room
kont	noun	room
kozijn	noun	room
lamp	noun	room
meubel	noun	room
meubilair	noun	room
muffig	adj	room
mug	noun	room
nachtkastje	noun	room
persoonskamer	noun	room
plafond	noun	room
plint	noun	room
radiator	noun	room
slaapkamer	noun	room
slot	noun	room
snikheet	adj	room
sofa	noun	room
spiegel	noun	room
standaard	adj	room
standaardkamer	noun	room
stijl	noun	room
studio	noun	room
suite	other	room
suite	noun	room
tapijt	noun	room
temperatuur	noun	room
uitzicht	noun	room
vensterbank	noun	room
ventilatie	noun	room
verwarming	noun	room
vitrage	noun	room
vloer	noun	room
vloerbedekking	noun	room
vloerbekleding	noun	room
vocht	noun	room
zeezicht	noun	room
zolderkamer	noun	room
afbladderen	verb	room
afmeting	noun	room
afvoer	noun	room
bedompt	adj	room
benauwd	adj	room
benauwen	verb	room
kitrand	noun	room
kleerkast	noun	room
krap	adj	room
lekkage	noun	room
lekken	verb	room
licht	noun	room
m2	other	room
netjes	adj	room
ruiken	verb	room
schimmel	noun	room
verouderd	adj	room
bouwput	noun	noise
dreunen	verb	noise
drilboor	noun	noise
dronken	adj	noise
gehorig.	adj	noise
gehorig	adj	noise
gehorigheid	noun	noise
geluid	noun	noise
geluidshinder	noun	noise
geluidsisolatie	noun	noise
geluidsoverlast	noun	noise
geschreeuw	noun	noise
gillen	verb	noise
hoorbaar	adj	noise
isolatie	noun	noise
kabaal	noun	noise
lawaai	noun	noise
lawaaierig	adj	noise
lawaaiig	adj	noise
lawaaioverlast	noun	noise
oordop	noun	noise
rumoerig	adj	noise
schreeuwen	verb	noise
stil	adj	noise
stilte	noun	noise
straatzijde	noun	noise
uitgaanspubliek	noun	noise
verkeerslawaai	noun	noise
afgelegen	adj	location
afstand	noun	location
airport	other	location
autoweg	noun	location
baai	noun	location
bakker	noun	location
bereikbaar	adj	location
bereikbaarheid	noun	location
bezienswaardigheid	noun	location
binnenplaats	noun	location
binnenstad	noun	location
bioscoop	noun	location
bos	noun	location
bosrijk	adj	location
boulevard	noun	location
bus	noun	location
bushalte	noun	location
busverbinding	noun	location
buurt	noun	location
centraal	adj	location
centraal	other	location
centrum.	noun	location
centrum	noun	location
concert	noun	location
dagkaart	noun	location
dichtbij	adj	location
dichterbij	adj	location
duin	noun	location
duinwandeling	noun	location
eettent	noun	location
fietsafstand	noun	location
fietspad	noun	location
fietsroute	noun	location
fietstocht	noun	location
groenplaats	other	location
grot	noun	location
halte	noun	location
handbereik	noun	location
hartje	noun	location
heuvel	noun	location
historisch	adj	location
hoek	noun	location
km.	noun	location
km	noun	location
kroeg	noun	location
kurhaus	other	location
kurhaus	noun	location
kust	noun	location
landgoed	noun	location
landschap	noun	location
ligging	noun	location
locatie	noun	location
lokatie	noun	location
loopafstand	noun	location
luchthaven	noun	location
markt	noun	location
meter	noun	location
metro	noun	location
metrostation	noun	location
minuut	noun	location
museum	noun	location
nabij	adj	location
nabijgelegen	adj	location
nabijheid	noun	location
natuur	noun	location
natuurgebied	noun	location
omgeving	noun	location
openbaarvervoer	noun	location
overkant	noun	location
pal	adj	location
paleis	noun	location
palm	noun	location
park	noun	location
pretpark	noun	location
s-bahn	other	location
schiphol	other	location
schiphol	noun	location
shuttle	noun	location
shuttlebus	noun	location
snelweg	noun	location
stad	noun	location
stadscentrum	noun	location
stadspark	noun	location
station	other	location
station	noun	location
steenworp	noun	location
straat	noun	location
supermarkt	noun	location
tegenover	prep	location
theater	noun	location
toplocatie	noun	location
tram	noun	location
trein	noun	location
treinstation	noun	location
uitgaanscentrum	noun	location
uitvalbasis	noun	location
uitvalsbasis	noun	location
uitvalsweg	noun	location
ver	adj	location
verkeer	noun	location
vlak	adv	location
vlakbij	adj	location
vlakbij	adv	location
vliegtuig	noun	location
vliegveld	noun	location
voet	noun	location
wandelafstand	noun	location
winkel	noun	location
winkelgebied	noun	location
woonwijk	noun	location
zee	other	location
zee	noun	location
zeezijde	noun	location
zicht	noun	location
activiteit	noun	breakfast
bacon	noun	breakfast
beleg	noun	breakfast
beschuit	noun	breakfast
boterham	noun	breakfast
broodsoort	noun	breakfast
buffet	noun	breakfast
cappucino	noun	breakfast
chocoladebroodje	noun	breakfast
cornflakes	noun	breakfast
croissant	noun	breakfast
ei	noun	breakfast
fruit	noun	breakfast
fruitsap	noun	breakfast
ham	noun	breakfast
jam	noun	breakfast
mango	noun	breakfast
melk	noun	breakfast
muesli	noun	breakfast
muffin	noun	breakfast
nespresso	noun	breakfast
omelet	noun	breakfast
onbijten	adj	breakfast
onbijten	noun	breakfast
ontbijd	noun	breakfast
ontbijt.	noun	breakfast
ontbijtbufet	noun	breakfast
ontbijtbuffet	verb	breakfast
ontbijtdame	noun	breakfast
ontbijtgraan	noun	breakfast
ontbijtkoek	noun	breakfast
ontbijtruimte	noun	breakfast
ontbijtruimte	verb	breakfast
ontbijttafel	noun	breakfast
ontbijttijd	noun	breakfast
ontbijtzaal	noun	breakfast
orange	other	breakfast
roerei	noun	breakfast
sap	noun	breakfast
spek	noun	breakfast
stokbrood	noun	breakfast
toast	noun	breakfast
uitgebreid	verb	breakfast
vleeswaren	noun	breakfast
vruchtensap	noun	breakfast
worst	noun	breakfast
yoghurt	noun	breakfast
zoetwaren	noun	breakfast
zout	adj	breakfast
garage	noun	parking
ondergronds	adj	parking
parkeergarage	noun	parking
parkeergeld	noun	parking
parkeergelegenheid	noun	parking
parkeergelegenheid	verb	parking
parkeerkaart	noun	parking
parkeerkosten	noun	parking
parkeermogelijkheid	noun	parking
parkeerplaats	noun	parking
parkeerplek	noun	parking
parkeerruimte	noun	parking
parkeerterrein	noun	parking
parkeervoorziening	noun	parking
parkeren	verb	parking
parking	noun	parking
q-park	other	parking
uitrijkaart	noun	parking
wagen	noun	parking
aandacht	noun	staff
aanvraag	noun	staff
aardig	adj	staff
afhandeling	noun	staff
afruimen	verb	staff
afsnauwen	verb	staff
afstandelijk	adj	staff
alert	adj	staff
arrogant	adj	staff
arrogantie	noun	staff
attent	adj	staff
balie	noun	staff
baliemedewerkster	noun	staff
baliepersoneel	noun	staff
barkeeper	noun	staff
barman	noun	staff
bediende	noun	staff
bedienen	verb	staff
bediening	noun	staff
behulpzaam.	noun	staff
behulpzaam	adj	staff
behulpzaamheid	noun	staff
bejegening	noun	staff
bekwaam	adj	staff
beleefd	adj	staff
bereidwillig	adj	staff
bestelling	noun	staff
binnenkomst	noun	staff
boeking	noun	staff
chagrijnig	adj	staff
chaotisch	adj	staff
chauffeur	noun	staff
checken	verb	staff
check-in	noun	staff
check-out	noun	staff
concierge	noun	staff
correct	adj	staff
dienstverlening	noun	staff
directeur	noun	staff
directie	noun	staff
discussie	noun	staff
dom	adj	staff
eigenaar	noun	staff
eigenaresse	noun	staff
excuus	noun	staff
executive	adj	staff
executive	other	staff
fatsoenlijk	adj	staff
flexibel	adj	staff
gast	noun	staff
gastvriendelijk	adj	staff
gastvrij	adj	staff
gastvrijheid	noun	staff
glimlach	noun	staff
hartelijk	adj	staff
helpen	verb	staff
hotelmedewerker	noun	staff
hotelpersoneel	noun	staff
hulp	noun	staff
hulpvaardig	adj	staff
incheckbalie	noun	staff
inchecken	noun	staff
inchecken	verb	staff
inchecktijd	noun	staff
kamermeisje	noun	staff
klant	noun	staff
klantgericht	adj	staff
klantonvriendelijk	adj	staff
klantvriendelijk	adj	staff
klantvriendelijkheid	noun	staff
kortaf	adj	staff
kundig	adj	staff
lazy	other	staff
lui	adj	staff
management	noun	staff
manager	noun	staff
medewerker	noun	staff
medewerkster	noun	staff
mentaliteit	noun	staff
nors	adj	staff
ober	noun	staff
onbeleefd	adj	staff
onbeschoft	adj	staff
onervaren	adj	staff
onpersoonlijk	adj	staff
onprofessioneel	adj	staff
onthaal	noun	staff
ontvangen	verb	staff
ontvangst	noun	staff
onvriendelijk	adj	staff
overboeken	verb	staff
overboeking	noun	staff
personeel.	noun	staff
personeel.	verb	staff
personeel	other	staff
personeel	noun	staff
personeelslid	noun	staff
professioneel	adj	staff
receptie	noun	staff
receptiepersoneel	adj	staff
receptiepersoneel	noun	staff
receptionist	noun	staff
receptioniste	noun	staff
reserveren	verb	staff
reservering	noun	staff
roomservice	noun	staff
serveerster	noun	staff
service	other	staff
service	noun	staff
servicegericht	adj	staff
servicegericht	noun	staff
soepel	adj	staff
staf	noun	staff
stagiaire	noun	staff
stug	adj	staff
supervriendelijk	adj	staff
team	other	staff
team	noun	staff
touroperator	noun	staff
uitchecken	noun	staff
uitchecken	verb	staff
verwelkoming	noun	staff
vlot	adj	staff
vriendelijk.	adj	staff
vriendelijk	adj	staff
vriendelijkheid	noun	staff
wegwijs	adj	staff
welkom	adj	staff
welkom	noun	staff
welkomsdrankje	noun	staff
welkomstdrankje	noun	staff
zorg	noun	staff
aanbieding	noun	value_for_money
aanbiedingsprijs	noun	value_for_money
afrekenen	verb	value_for_money
afrekening	noun	value_for_money
bedrag	noun	value_for_money
berekenen	verb	value_for_money
betaalbaar	adj	value_for_money
betalen	verb	value_for_money
betaling	noun	value_for_money
bijbetalen	verb	value_for_money
bijbetaling	noun	value_for_money
budget	noun	value_for_money
cent	noun	value_for_money
compensatie	noun	value_for_money
creditcard	noun	value_for_money
deal	noun	value_for_money
duur	adj	value_for_money
eur	other	value_for_money
eur	noun	value_for_money
euro	other	value_for_money
euro	noun	value_for_money
factuur	noun	value_for_money
fors	adj	value_for_money
geld	noun	value_for_money
goedkoop	adj	value_for_money
gratis	adj	value_for_money
gratis	other	value_for_money
hoofdprijs	noun	value_for_money
inbegrepen	adj	value_for_money
kamerprijs	noun	value_for_money
korting	noun	value_for_money
kortingsbon	noun	value_for_money
kost	noun	value_for_money
kosteloos	adj	value_for_money
kosten	noun	value_for_money
kosten	verb	value_for_money
kostenloos	adj	value_for_money
kwaliteitsverhouding	noun	value_for_money
kwaliteitverhouding	noun	value_for_money
meerprijs	noun	value_for_money
p.p.	other	value_for_money
prijs	other	value_for_money
prijs	noun	value_for_money
prijs|kwaliteit	noun	value_for_money
prijs|kwaliteit	verb	value_for_money
prijs|kwaliteitsverhouding	noun	value_for_money
prijs|kwaliteitverhouding	noun	value_for_money
prijs-kwaliteit	noun	value_for_money
prijs-kwaliteitsverhouding	noun	value_for_money
prijs-kwaliteitverhouding	noun	value_for_money
prijzig	adj	value_for_money
rekenen	verb	value_for_money
rekening	noun	value_for_money
schappelijk	adj	value_for_money
tarief	noun	value_for_money
tientje	noun	value_for_money
toeristenbelasting	noun	value_for_money
toeslag	noun	value_for_money
uitgeven	verb	value_for_money
voordeel	noun	value_for_money
3-gang	other	restaurant
3-gang	noun	restaurant
3-gangendiner	noun	restaurant
3-gangenmenu	noun	restaurant
4-gang	other	restaurant
4-gangenmenu	noun	restaurant
5-gang	other	restaurant
aanvullen	verb	restaurant
aardappel	noun	restaurant
afbakken	verb	restaurant
asperge	noun	restaurant
avondeten	noun	restaurant
avondmaal	noun	restaurant
bakken	verb	restaurant
bar	noun	restaurant
biefstuk	noun	restaurant
bier	noun	restaurant
biertje	noun	restaurant
bijvullen	verb	restaurant
bitterbal	noun	restaurant
bord	noun	restaurant
borrel	noun	restaurant
borrelen	verb	restaurant
brasserie	noun	restaurant
brie	noun	restaurant
brood	noun	restaurant
brunch	noun	restaurant
cafe	noun	restaurant
cake	noun	restaurant
carte	other	restaurant
champagne	noun	restaurant
champignon	noun	restaurant
chef	noun	restaurant
chefkok	noun	restaurant
cocktail	noun	restaurant
coctail	noun	restaurant
cola	noun	restaurant
culinair	adj	restaurant
dagmenu	noun	restaurant
dessert	noun	restaurant
dieet	noun	restaurant
diner	noun	restaurant
dinerbuffet	noun	restaurant
diner-buffet	noun	restaurant
dineren	noun	restaurant
dineren	verb	restaurant
dinner	other	restaurant
drank	noun	restaurant
drankje	noun	restaurant
drinken	verb	restaurant
eetcafe	noun	restaurant
eetgelegenheid	noun	restaurant
eetzaal	noun	restaurant
eitje	noun	restaurant
eten.	verb	restaurant
eten	other	restaurant
eten	noun	restaurant
eten	verb	restaurant
eter	noun	restaurant
fruitsalade	noun	restaurant
gangendiner	noun	restaurant
gangenmenu	noun	restaurant
gastronomisch	adj	restaurant
gerecht	noun	restaurant
groente	noun	restaurant
hap	noun	restaurant
hapje	noun	restaurant
hartig	adj	restaurant
hoofdgerecht	noun	restaurant
hotelbar	noun	restaurant
hotelrestaurant	noun	restaurant
huiswijn	noun	restaurant
ingredient	noun	restaurant
jus	noun	restaurant
kaas	noun	restaurant
karig	adj	restaurant
kerstdiner	noun	restaurant
keuzemenu	noun	restaurant
kindermenu	noun	restaurant
kinderstoel	noun	restaurant
kip	noun	restaurant
kipfilet	noun	restaurant
koffie	noun	restaurant
koffie|thee	adj	restaurant
koffie|thee	noun	restaurant
kok	noun	restaurant
lekker	adj	restaurant
lunch	noun	restaurant
lunchen	verb	restaurant
maaltijd	noun	restaurant
menu	noun	restaurant
menukaart	noun	restaurant
nagerecht	noun	restaurant
nuttigen	verb	restaurant
ontbijt	noun	restaurant
ontbijtbuffet	noun	restaurant
ontbijten	verb	restaurant
ontbijtzaal	adj	restaurant
opdienen	verb	restaurant
pannenkoek	noun	restaurant
pizza	noun	restaurant
poffertje	noun	restaurant
portie	noun	restaurant
rauw	adj	restaurant
reataurant	noun	restaurant
restaurant	other	restaurant
restaurant	noun	restaurant
salade	noun	restaurant
serveren	verb	restaurant
servies	noun	restaurant
sinaasappelsap	noun	restaurant
sjalotte	other	restaurant
sla	noun	restaurant
smakelijk	adj	restaurant
smaken	verb	restaurant
snack	noun	restaurant
snitzel	noun	restaurant
soep	noun	restaurant
sushi	noun	restaurant
taai	adj	restaurant
tafel	noun	restaurant
tafelen	verb	restaurant
tea	other	restaurant
thee	noun	restaurant
thee|koffie	noun	restaurant
theefaciliteit	noun	restaurant
toetje	noun	restaurant
tournedos	noun	restaurant
uitgebreid	adj	restaurant
varkenshaas	noun	restaurant
vers	adj	restaurant
vers	noun	restaurant
vis	noun	restaurant
vlees	noun	restaurant
voorgerecht	noun	restaurant
wijn	noun	restaurant
wijnglas	noun	restaurant
wijnkaart	noun	restaurant
zalm	noun	restaurant
bad	other	bathroom
bad	noun	bathroom
bad|douche	adj	bathroom
badhanddoek	noun	bathroom
badjas	noun	bathroom
badkamer	noun	bathroom
badkamerdeur	noun	bathroom
badkraan	noun	bathroom
badkuip	noun	bathroom
badlaken	noun	bathroom
badruimte	noun	bathroom
badschuim	noun	bathroom
bain	other	bathroom
bodem	noun	bathroom
bubbel	noun	bathroom
bubbelbad	noun	bathroom
douche	adj	bathroom
douche	noun	bathroom
douche|bad	noun	bathroom
douchebak	noun	bathroom
douchecabine	noun	bathroom
douchegel	noun	bathroom
douchegordijn	noun	bathroom
douchehok	noun	bathroom
douchekop	noun	bathroom
douchen	verb	bathroom
doucheput	noun	bathroom
doucheslang	noun	bathroom
douchewand	noun	bathroom
fohn	noun	bathroom
haardroger	noun	bathroom
handdoek	noun	bathroom
handoek	noun	bathroom
inloopdouche	adj	bathroom
inloopdouche	noun	bathroom
jacuzzi	noun	bathroom
kalkaanslag	noun	bathroom
kraan	noun	bathroom
kraanwater	noun	bathroom
lauw	adj	bathroom
ligbad	noun	bathroom
mengkraan	noun	bathroom
nat	adj	bathroom
rainshower	noun	bathroom
regendouche	noun	bathroom
sanitair	adj	bathroom
sanitair	noun	bathroom
stoombad	noun	bathroom
stortdouche	adj	bathroom
stromen	verb	bathroom
tegel	noun	bathroom
thermostaatkraan	noun	bathroom
toilet	noun	bathroom
toiletborstel	noun	bathroom
toiletpapier	noun	bathroom
voeg	noun	bathroom
washand	noun	bathroom
wastafel	noun	bathroom
water	noun	bathroom
watten	noun	bathroom
wc	noun	bathroom
wellne	noun	bathroom
wirlpool	noun	bathroom
zeepbakje	noun	bathroom
zeepje	noun	bathroom
binnenzwembad	noun	swimming_pool
buitenzwembad	noun	swimming_pool
duik	noun	swimming_pool
ligbed	noun	swimming_pool
ligstoel	noun	swimming_pool
parasol	noun	swimming_pool
strandstoel	noun	swimming_pool
whirlpool	noun	swimming_pool
zwembad	noun	swimming_pool
zwembadwater	noun	swimming_pool
zwemles	noun	swimming_pool
zwemmen	verb	swimming_pool
minibar	noun	bar
2-persoonsbed	noun	sleeping_comfort
bed	other	sleeping_comfort
bed	noun	sleeping_comfort
beddegoed	noun	sleeping_comfort
beddengoed	noun	sleeping_comfort
dekbed	noun	sleeping_comfort
deken	noun	sleeping_comfort
doorliggen	verb	sleeping_comfort
eenpersoonsbed	noun	sleeping_comfort
hoofdkussen	noun	sleeping_comfort
kinderbed	noun	sleeping_comfort
kingsize	adj	sleeping_comfort
kussen	noun	sleeping_comfort
laken	noun	sleeping_comfort
matras	noun	sleeping_comfort
nachtrust	noun	sleeping_comfort
opstaan	verb	sleeping_comfort
persoonsbed	noun	sleeping_comfort
rugklachten	noun	sleeping_comfort
rugpijn	noun	sleeping_comfort
slaapbank	noun	sleeping_comfort
slapen	verb	sleeping_comfort
stapelbed	noun	sleeping_comfort
tweepersoonsbed	noun	sleeping_comfort
twijfelaar	noun	sleeping_comfort
uitslapen	verb	sleeping_comfort
wakker	adj	sleeping_comfort
4-sterrenhotel	noun	facilities
accommodatie	noun	facilities
accomodatie	noun	facilities
afstandbediening	noun	facilities
afstandsbediening	noun	facilities
arrangement	other	facilities
attractie	noun	facilities
babybed	noun	facilities
badhotel	other	facilities
badhotel	noun	facilities
bagage	noun	facilities
ballenbak	noun	facilities
bar	adj	facilities
bar	other	facilities
beachbar	noun	facilities
beachclub	noun	facilities
beautycentrum	noun	facilities
bergruimte	noun	facilities
binnentuin	noun	facilities
bios	noun	facilities
bistro	noun	facilities
boottocht	noun	facilities
bowlen	verb	facilities
bowling	noun	facilities
bowlingbaan	noun	facilities
boxspringen	noun	facilities
bridge	other	facilities
broekenpers	noun	facilities
buitenkant	noun	facilities
buitenterras	noun	facilities
camping	noun	facilities
casino	other	facilities
casino	noun	facilities
circustheater	other	facilities
citytrip	noun	facilities
cocktailbar	noun	facilities
dakterras	noun	facilities
delux	noun	facilities
deluxe	other	facilities
diepvries	noun	facilities
disco	noun	facilities
discotheek	noun	facilities
duikschool	noun	facilities
dvd's	noun	facilities
dvd-speler	noun	facilities
efteling	other	facilities
email	noun	facilities
e-mail	noun	facilities
entourage	noun	facilities
entree	noun	facilities
etage	noun	facilities
eurodisney	other	facilities
excursie	noun	facilities
faciliteit	noun	facilities
familiekamer	noun	facilities
fiets	noun	facilities
fietsen	verb	facilities
fietsenstalling	noun	facilities
fietshuur	noun	facilities
fietsverhuur	noun	facilities
fitness	noun	facilities
fitnessruimte	noun	facilities
flatscreen	noun	facilities
flatscreenen	other	facilities
gebouw	noun	facilities
glijbaan	noun	facilities
golfbaan	noun	facilities
hal	noun	facilities
halfpension	adj	facilities
handdoekenservice	noun	facilities
herenhuis	noun	facilities
hoeve	noun	facilities
hond	noun	facilities
huisdier	noun	facilities
huurfiets	noun	facilities
ijskast	noun	facilities
juniorsuite	noun	facilities
kasteel	noun	facilities
kasteelkamer	noun	facilities
kinderwagen	noun	facilities
kluis	noun	facilities
koeling	noun	facilities
koelkast	noun	facilities
koetshuis	noun	facilities
koffieautomaat	noun	facilities
kookplaat	noun	facilities
lift	noun	facilities
living	noun	facilities
lobby	other	facilities
lobby	noun	facilities
lounge	noun	facilities
luxekamer	noun	facilities
magnetron	noun	facilities
massage	noun	facilities
minibar	adj	facilities
motel	noun	facilities
musical	noun	facilities
park	other	facilities
patio	noun	facilities
pendelbus	noun	facilities
penthouse	noun	facilities
persen	verb	facilities
piano	noun	facilities
pool	noun	facilities
poolbiljart	noun	facilities
pub	noun	facilities
radio	noun	facilities
resort	other	facilities
roken	verb	facilities
rokerskamer	noun	facilities
rolstoel	noun	facilities
rookvrij	adj	facilities
royal	other	facilities
sauna	noun	facilities
saunacomplex	noun	facilities
serre	noun	facilities
shop	noun	facilities
shoppen	verb	facilities
shopping	other	facilities
shuttelbus	noun	facilities
shuttleservice	noun	facilities
ski	noun	facilities
solarium	noun	facilities
speeltuin	noun	facilities
speler	noun	facilities
sport	noun	facilities
sportcentrum	noun	facilities
sporten	verb	facilities
sportfaciliteit	noun	facilities
sportschool	noun	facilities
springkussen	noun	facilities
squash	noun	facilities
strand	other	facilities
strijkijzer	noun	facilities
strijkplank	noun	facilities
t.v.	noun	facilities
tafeltennis	noun	facilities
taxi	noun	facilities
telefoon	noun	facilities
televisie	noun	facilities
tennis	noun	facilities
tennisbaan	noun	facilities
teras	noun	facilities
terras	noun	facilities
theezetfaciliteit	noun	facilities
tuin	noun	facilities
tv	noun	facilities
tweepersoons	adj	facilities
tweepersoonskamer	noun	facilities
uitgaansgelegenheid	noun	facilities
uitgaansleven	noun	facilities
vaatwasser	noun	facilities
ventilator	noun	facilities
vervoer	noun	facilities
viersterrenhotel	noun	facilities
voorziening	noun	facilities
wandelen	verb	facilities
wandelgebied	noun	facilities
wandeling	noun	facilities
wandelroute	noun	facilities
wasmachine	noun	facilities
waterkoker	noun	facilities
wellness	other	facilities
wellness	noun	facilities
welness	other	facilities
welness	noun	facilities
winkelcentrum	noun	facilities
winkelen	verb	facilities
winkelstraat	noun	facilities
winkeltje	noun	facilities
wintertuin	noun	facilities
zender	noun	facilities
bloed	noun	cleanliness
bloedvlek	noun	cleanliness
